random_label;slide #;Intersect #;Coils;Hyphae;Spikes;no colonization;roots_crossed
1;1;1;0;0;0;0;0
1;1;2;1;1;1;1;2
1;1;3;3;1;2;9;12
1;1;4;2;3;1;12;14
1;1;5;0;0;0;8;8
1;1;6;0;1;0;5;5
1;1;7;0;0;0;1;1
1;1;8;0;0;0;0;0
1;1;9;0;0;0;2;2
1;1;10;2;3;1;6;8
1;1;11;5;4;2;9;14
1;1;12;6;5;1;7;13
1;1;13;8;10;1;8;16
1;1;14;2;3;0;5;7
1;1;15;1;1;0;5;6
1;1;16;1;2;0;2;3
1;1;17;0;0;0;0;0
1;1;18;0;0;0;0;0
1;1;19;0;0;0;0;0
1;1;20;0;0;0;0;0
1;2;21;0;0;0;2;2
1;2;22;3;1;0;0;3
1;2;23;2;1;0;4;6
1;2;24;1;2;0;4;5
1;2;25;4;0;0;9;13
1;2;26;1;0;0;6;7
1;2;27;0;0;0;1;1
1;2;28;0;0;0;1;1
1;2;29;0;0;0;0;0
1;2;30;0;0;0;0;0
1;2;31;0;0;0;0;0
1;2;32;2;2;0;2;4
1;2;33;4;3;0;5;9
1;2;34;6;5;2;7;13
1;2;35;5;4;4;5;10
1;2;36;4;5;0;1;5
1;2;37;0;0;0;0;0
1;2;38;0;0;0;0;0
1;2;39;0;0;0;0;0
1;2;40;0;0;0;0;0
3;1;1;0;0;0;0;0
3;1;2;0;0;0;3;3
3;1;3;0;0;0;12;12
3;1;4;1;0;0;8;9
3;1;5;0;0;0;8;8
3;1;6;0;0;0;5;5
3;1;7;0;0;0;4;4
3;1;8;0;0;0;4;4
3;1;9;0;0;0;3;3
3;1;10;0;0;0;2;2
3;1;11;0;0;0;1;1
3;1;12;0;0;0;0;0
3;1;13;0;0;0;1;1
3;1;14;0;0;0;1;1
3;1;15;0;0;0;1;1
3;1;16;0;0;0;4;4
3;1;17;0;0;0;9;9
3;1;18;0;0;0;11;11
3;1;19;0;0;0;12;12
3;1;20;0;0;0;8;8
3;1;21;0;0;0;7;7
3;1;22;0;0;0;12;12
3;1;23;0;0;0;13;13
3;1;24;0;0;0;8;8
3;1;25;0;0;0;0;0
3;1;26;0;0;0;0;0
3;1;27;0;0;0;0;0
3;1;28;0;0;0;0;0
3;1;29;0;0;0;0;0
3;1;30;0;0;0;0;0
3;1;31;0;0;0;0;0
3;1;32;0;0;0;0;0
3;1;33;0;0;0;0;0
3;1;34;0;0;0;0;0
3;1;35;0;0;0;0;0
3;1;36;0;0;0;0;0
3;1;37;0;0;0;0;0
3;1;38;0;0;0;0;0
3;1;39;0;0;0;0;0
3;1;40;0;0;0;0;0
4;1;1;1;0;0;1;2
4;1;2;3;1;0;8;11
4;1;3;3;2;0;10;13
4;1;4;7;2;0;11;18
4;1;5;4;0;0;5;9
4;1;6;0;0;0;4;4
4;1;7;1;0;0;4;5
4;1;8;0;1;0;2;2
4;1;9;0;0;0;1;1
4;1;10;0;0;0;0;0
4;1;11;1;0;0;2;3
4;1;12;1;0;0;4;5
4;1;13;3;1;0;3;6
4;1;14;4;0;0;3;7
4;1;15;2;2;0;1;3
4;1;16;1;0;0;3;4
4;1;17;9;4;0;7;16
4;1;18;1;0;0;3;4
4;1;19;2;0;0;1;3
4;1;20;3;1;0;2;5
4;2;21;0;0;0;1;1
4;2;22;0;0;0;1;1
4;2;23;2;2;0;2;4
4;2;24;2;1;0;9;11
4;2;25;2;1;0;0;2
4;2;26;1;0;0;1;2
4;2;27;2;1;0;0;2
4;2;28;2;2;0;1;3
4;2;29;1;0;0;0;1
4;2;30;0;0;0;0;0
4;2;31;0;0;0;0;0
4;2;32;0;0;0;0;0
4;2;33;1;0;0;2;3
4;2;34;0;0;0;2;2
4;2;35;3;3;0;7;10
4;2;36;4;5;0;1;5
4;2;37;0;0;0;0;0
4;2;38;0;0;0;0;0
4;2;39;0;0;0;0;0
4;2;40;0;0;0;0;0
8;1;1;0;0;0;0;0
8;1;2;5;4;0;4;9
8;1;3;5;1;0;0;5
8;1;4;5;2;0;2;7
8;1;5;5;7;0;3;8
8;1;6;2;2;0;0;2
8;1;7;1;2;0;1;2
8;1;8;0;0;0;0;0
8;1;9;1;1;0;0;1
8;1;10;4;0;0;0;4
8;1;11;4;5;0;1;5
8;1;12;6;6;0;1;7
8;1;13;3;2;0;1;4
8;1;14;1;1;0;0;1
8;1;15;0;0;0;1;1
8;1;16;0;0;0;0;0
8;1;17;0;0;0;0;0
8;1;18;0;0;0;0;0
8;1;19;0;0;0;0;0
8;1;20;0;0;0;0;0
8;2;21;0;0;0;0;0
8;2;22;3;4;0;1;4
8;2;23;7;4;0;2;9
8;2;24;6;4;0;1;7
8;2;25;3;3;0;1;4
8;2;26;1;2;0;2;3
8;2;27;2;1;0;0;2
8;2;28;2;1;0;2;4
8;2;29;0;0;0;1;1
8;2;30;0;0;0;0;0
8;2;31;0;0;0;1;1
8;2;32;1;1;0;0;1
8;2;33;2;2;0;0;2
8;2;34;1;1;0;0;1
8;2;35;0;0;0;0;0
8;2;36;0;0;0;0;0
8;2;37;0;0;0;0;0
8;2;38;0;0;0;0;0
8;2;39;0;0;0;0;0
8;2;40;0;0;0;0;0
26;1;1;0;0;0;0;0
26;1;2;0;0;0;8;8
26;1;3;1;1;0;21;22
26;1;4;0;1;0;14;14
26;1;5;0;1;0;8;8
26;1;6;0;0;0;1;1
26;1;7;0;0;0;0;0
26;1;8;0;0;0;0;0
26;1;9;0;0;0;4;4
26;1;10;1;0;0;4;5
26;1;11;1;0;0;12;13
26;1;12;0;0;0;5;5
26;1;13;0;0;0;6;6
26;1;14;0;0;0;4;4
26;1;15;0;0;0;6;6
26;1;16;0;0;0;6;6
26;1;17;0;0;0;3;3
26;1;18;0;0;0;0;0
26;1;19;0;0;0;0;0
26;1;20;0;0;0;0;0
26;2;21;0;0;0;2;2
26;2;22;0;0;0;8;8
26;2;23;3;0;0;12;15
26;2;24;2;0;0;11;13
26;2;25;1;0;0;7;8
26;2;26;1;0;0;5;6
26;2;27;0;0;0;6;6
26;2;28;0;0;0;3;3
26;2;29;0;0;0;0;0
26;2;30;1;0;0;4;5
26;2;31;0;0;0;12;12
26;2;32;1;0;0;23;24
26;2;33;0;0;0;8;8
26;2;34;0;0;0;6;6
26;2;35;0;0;0;0;0
26;2;36;0;0;0;0;0
26;2;37;0;0;0;0;0
26;2;38;0;0;0;0;0
26;2;39;0;0;0;0;0
26;2;40;0;0;0;0;0
60;1;1;0;0;0;0;0
60;1;2;0;0;0;4;4
60;1;3;1;0;0;23;24
60;1;4;0;0;0;11;11
60;1;5;0;0;0;10;10
60;1;6;0;0;0;4;4
60;1;7;0;0;0;0;0
60;1;8;0;0;0;0;0
60;1;9;0;0;0;0;0
60;1;10;0;0;0;8;8
60;1;11;0;0;0;16;16
60;1;12;0;0;0;13;13
60;1;13;0;0;0;6;6
60;1;14;0;0;0;1;1
60;1;15;0;0;0;0;0
60;1;16;0;0;0;0;0
60;1;17;0;0;0;0;0
60;1;18;0;0;0;0;0
60;1;19;0;0;0;0;0
60;1;20;0;0;0;0;0
60;2;21;0;0;0;0;0
60;2;22;0;0;0;3;3
60;2;23;0;0;0;6;6
60;2;24;0;0;0;10;10
60;2;25;0;0;0;4;4
60;2;26;0;0;0;8;8
60;2;27;0;0;0;2;2
60;2;28;0;0;0;1;1
60;2;29;0;0;0;2;2
60;2;30;0;0;0;0;0
60;2;31;0;0;0;0;0
60;2;32;0;0;0;0;0
60;2;33;0;0;0;2;2
60;2;34;0;0;0;5;5
60;2;35;0;0;0;4;4
60;2;36;0;0;0;3;3
60;2;37;0;0;0;2;2
60;2;38;0;0;0;0;0
60;2;39;0;0;0;0;0
60;2;40;0;0;0;0;0
61;1;1;0;0;0;0;0
61;1;2;0;0;0;1;1
61;1;3;0;0;0;5;5
61;1;4;0;0;0;8;8
61;1;5;1;0;0;10;11
61;1;6;0;0;0;15;15
61;1;7;0;0;0;7;7
61;1;8;1;0;0;2;3
61;1;9;0;0;0;0;0
61;1;10;0;0;0;0;0
61;1;11;0;0;0;0;0
61;1;12;0;0;0;2;2
61;1;13;0;0;0;13;13
61;1;14;0;0;0;13;13
61;1;15;0;0;0;8;8
61;1;16;0;0;0;8;8
61;1;17;0;0;0;5;5
61;1;18;0;0;0;5;5
61;1;19;0;0;0;2;2
61;1;20;0;0;0;0;0
61;2;21;0;0;0;0;0
61;2;22;0;0;0;4;4
61;2;23;0;0;0;15;15
61;2;24;1;0;0;12;13
61;2;25;0;0;0;13;13
61;2;26;0;0;0;8;8
61;2;27;0;0;0;5;5
61;2;28;0;0;0;3;3
61;2;29;0;0;0;1;1
61;2;30;0;0;0;0;0
61;2;31;0;0;0;0;0
61;2;32;0;0;0;1;1
61;2;33;0;0;0;7;7
61;2;34;0;0;0;11;11
61;2;35;0;0;0;13;13
61;2;36;0;0;0;12;12
61;2;37;0;0;0;10;10
61;2;38;0;0;0;7;7
61;2;39;0;0;0;0;0
61;2;40;0;0;0;0;0
65;1;1;0;0;0;1;1
65;1;2;0;0;0;7;7
65;1;3;0;1;0;10;10
65;1;4;3;0;0;12;15
65;1;5;2;3;0;16;18
65;1;6;1;0;0;12;13
65;1;7;1;0;0;6;7
65;1;8;0;0;0;4;4
65;1;9;0;0;0;3;3
65;1;10;0;0;0;4;4
65;1;11;0;0;0;0;0
65;1;12;0;0;0;0;0
65;1;13;0;0;0;0;0
65;1;14;1;1;0;6;7
65;1;15;0;0;0;9;9
65;1;16;0;0;0;3;3
65;1;17;0;0;0;1;1
65;1;18;0;0;0;1;1
65;1;19;0;0;0;0;0
65;1;20;0;0;0;0;0
65;2;21;0;0;0;0;0
65;2;22;0;0;0;0;0
65;2;23;1;1;0;6;7
65;2;24;0;1;0;4;4
65;2;25;0;0;0;3;3
65;2;26;0;0;0;1;1
65;2;27;0;0;0;1;1
65;2;28;0;0;0;0;0
65;2;29;0;0;0;0;0
65;2;30;0;0;0;0;0
65;2;31;0;0;0;0;0
65;2;32;1;2;0;1;2
65;2;33;3;2;0;2;5
65;2;34;0;0;0;4;4
65;2;35;0;0;0;0;0
65;2;36;0;0;0;0;0
65;2;37;0;0;0;0;0
65;2;38;0;0;0;0;0
65;2;39;0;0;0;0;0
65;2;40;0;0;0;0;0
74;1;1;0;0;0;0;0
74;1;2;5;1;0;1;6
74;1;3;6;3;0;2;8
74;1;4;1;1;0;4;5
74;1;5;3;1;0;0;3
74;1;6;0;0;0;0;0
74;1;7;0;0;0;0;0
74;1;8;0;0;0;0;0
74;1;9;5;3;0;1;6
74;1;10;2;2;0;8;10
74;1;11;4;2;0;6;10
74;1;12;6;0;0;0;6
74;1;13;4;2;0;2;6
74;1;14;0;0;0;1;1
74;1;15;0;0;0;0;0
74;1;16;0;0;0;0;0
74;1;17;0;0;0;0;0
74;1;18;0;0;0;0;0
74;1;19;0;0;0;0;0
74;1;20;0;0;0;0;0
74;2;21;0;0;0;0;0
74;2;22;2;2;0;4;6
74;2;23;14;11;0;10;24
74;2;24;7;5;0;6;13
74;2;25;6;4;0;3;9
74;2;26;5;3;0;0;5
74;2;27;0;0;0;0;0
74;2;28;0;0;0;0;0
74;2;29;1;1;0;1;2
74;2;30;4;3;0;2;6
74;2;31;11;10;0;7;18
74;2;32;8;4;0;8;16
74;2;33;4;2;0;5;9
74;2;34;0;4;0;6;6
74;2;35;0;0;0;0;0
74;2;36;0;0;0;0;0
74;2;37;0;0;0;0;0
74;2;38;0;0;0;0;0
74;2;39;0;0;0;0;0
74;2;40;0;0;0;0;0
77;1;1;0;0;0;0;0
77;1;2;3;1;0;3;6
77;1;3;4;0;0;9;13
77;1;4;3;1;0;11;14
77;1;5;2;0;0;13;15
77;1;6;2;0;0;21;23
77;1;7;3;0;0;18;21
77;1;8;3;2;0;16;19
77;1;9;0;0;0;2;2
77;1;10;2;0;0;9;11
77;1;11;1;0;0;3;4
77;1;12;0;0;0;1;1
77;1;13;5;0;0;8;13
77;1;14;2;0;0;21;23
77;1;15;8;0;0;20;28
77;1;16;5;1;0;21;26
77;1;17;2;1;0;9;11
77;1;18;3;0;0;9;12
77;1;19;0;0;0;5;5
77;1;20;0;0;0;3;3
77;2;21;0;0;0;0;0
77;2;22;1;0;0;2;3
77;2;23;2;1;0;2;4
77;2;24;0;0;0;5;5
77;2;25;0;0;0;4;4
77;2;26;0;0;0;1;1
77;2;27;0;0;0;0;0
77;2;28;0;0;0;0;0
77;2;29;0;0;0;0;0
77;2;30;2;0;0;8;10
77;2;31;3;0;0;13;16
77;2;32;6;0;0;13;19
77;2;33;0;0;0;13;13
77;2;34;0;0;0;6;6
77;2;35;0;0;0;4;4
77;2;36;0;0;0;1;1
77;2;37;0;0;0;0;0
77;2;38;0;0;0;0;0
77;2;39;0;0;0;0;0
77;2;40;0;0;0;0;0
29;1;1;0;0;0;0;0
29;1;2;1;1;0;3;4
29;1;3;1;1;1;5;6
29;1;4;0;1;0;4;4
29;1;5;1;1;0;4;5
29;1;6;0;2;0;4;4
29;1;7;1;0;0;5;6
29;1;8;0;0;0;3;3
29;1;9;0;0;0;2;2
29;1;10;0;0;0;2;2
29;1;11;0;0;0;1;1
29;1;12;0;0;0;1;1
29;1;13;0;0;0;1;1
29;1;14;1;1;0;1;2
29;1;15;1;1;0;0;1
29;1;16;2;3;0;8;10
29;1;17;2;3;0;4;6
29;1;18;1;6;0;10;11
29;1;19;1;3;0;9;10
29;1;20;1;2;0;6;7
29;1;21;1;0;0;3;4
29;1;22;2;0;0;1;3
29;1;23;0;0;0;2;2
29;1;24;1;1;2;3;4
29;1;25;0;0;0;0;0
29;1;26;0;0;0;0;0
29;1;27;0;0;0;0;0
29;1;28;0;0;0;0;0
29;1;29;0;0;0;0;0
29;1;30;0;0;0;0;0
29;2;31;0;0;0;0;0
29;2;32;0;1;0;2;2
29;2;33;2;1;0;3;5
29;2;34;1;0;0;11;12
29;2;35;0;0;1;11;11
29;2;36;1;0;1;6;7
29;2;37;0;1;0;2;2
29;2;38;0;0;0;1;1
29;2;39;0;0;0;0;0
29;2;40;0;0;0;0;0
67;1;1;0;0;0;0;0
67;1;2;0;0;0;2;2
67;1;3;0;0;0;10;10
67;1;4;0;0;0;13;13
67;1;5;1;0;0;9;10
67;1;6;0;0;0;15;15
67;1;7;0;0;0;8;8
67;1;8;0;0;0;3;3
67;1;9;0;0;0;4;4
67;1;10;0;0;0;1;1
67;1;11;0;0;0;1;1
67;1;12;0;0;0;0;0
67;1;13;0;0;0;0;0
67;1;14;0;0;0;0;0
67;1;15;0;0;0;0;0
67;1;16;1;0;0;2;3
67;1;17;0;0;0;7;7
67;1;18;1;0;0;17;18
67;1;19;0;0;0;27;27
67;1;20;1;0;0;18;19
67;1;21;0;0;0;3;3
67;1;22;0;0;0;0;0
67;1;23;0;0;0;0;0
67;1;24;0;0;0;0;0
67;1;25;0;0;0;0;0
67;1;26;0;0;0;0;0
67;1;27;0;0;0;0;0
67;1;28;0;0;0;0;0
67;1;29;0;0;0;0;0
67;1;30;0;0;0;0;0
67;2;31;0;0;0;0;0
67;2;32;0;0;0;0;0
67;2;33;0;0;0;4;4
67;2;34;0;0;0;10;10
67;2;35;0;0;0;16;16
67;2;36;0;0;0;11;11
67;2;37;0;0;0;3;3
67;2;38;0;0;0;0;0
67;2;39;0;0;0;0;0
67;2;40;0;0;0;0;0
69;1;1;0;0;0;1;1
69;1;2;3;1;0;9;12
69;1;3;3;0;0;15;18
69;1;4;2;0;0;11;13
69;1;5;3;0;0;8;11
69;1;6;3;2;0;7;10
69;1;7;0;0;0;4;4
69;1;8;0;0;0;3;3
69;1;9;1;1;0;1;2
69;1;10;0;0;0;0;0
69;1;11;0;0;0;0;0
69;1;12;0;0;0;0;0
69;1;13;0;0;0;0;0
69;1;14;1;0;0;1;2
69;1;15;1;0;0;5;6
69;1;16;3;0;0;11;14
69;1;17;2;0;0;8;10
69;1;18;6;2;0;20;26
69;1;19;7;4;0;20;27
69;1;20;0;0;0;3;3
69;1;21;0;0;0;0;0
69;1;22;0;0;0;0;0
69;1;23;0;0;0;0;0
69;1;24;0;0;0;0;0
69;1;25;0;0;0;0;0
69;1;26;0;0;0;0;0
69;1;27;0;0;0;0;0
69;1;28;0;0;0;0;0
69;1;29;0;0;0;0;0
69;1;30;0;0;0;0;0
69;2;31;0;0;0;0;0
69;2;32;0;0;0;0;0
69;2;33;0;0;0;2;2
69;2;34;2;2;0;12;14
69;2;35;2;0;0;18;20
69;2;36;0;0;0;12;12
69;2;37;0;0;0;12;12
69;2;38;1;0;0;16;17
69;2;39;0;0;0;4;4
69;2;40;1;0;0;10;11
5;1;1;0;0;0;0;0
5;1;2;0;0;0;7;7
5;1;3;0;0;0;7;7
5;1;4;0;0;0;7;7
5;1;5;0;0;0;5;5
5;1;6;0;0;0;7;7
5;1;7;0;0;0;7;7
5;1;8;0;0;0;6;6
5;1;9;0;0;0;4;4
5;1;10;0;0;0;6;6
5;1;11;0;0;0;5;5
5;1;12;0;0;0;4;4
5;1;13;0;0;0;3;3
5;1;14;0;0;0;1;1
5;1;15;0;0;0;0;0
5;1;16;0;0;0;0;0
5;1;17;0;0;0;0;0
5;1;18;0;0;0;0;0
5;1;19;0;0;0;0;0
5;1;20;0;0;0;5;5
5;1;21;0;0;0;6;6
5;1;22;0;0;0;8;8
5;1;23;0;0;0;9;9
5;1;24;0;0;0;14;14
5;1;25;0;0;0;10;10
5;1;26;1;0;0;8;9
5;1;27;0;0;0;6;6
5;1;28;0;0;0;3;3
5;1;29;0;0;0;1;1
5;1;30;0;0;0;2;2
5;1;31;0;0;0;2;2
5;1;32;0;0;0;2;2
5;1;33;0;0;0;0;0
5;1;34;0;0;0;0;0
5;1;35;0;0;0;0;0
5;1;36;0;0;0;0;0
5;1;37;0;0;0;0;0
5;1;38;0;0;0;0;0
5;1;39;0;0;0;0;0
5;1;40;0;0;0;0;0
6;1;1;0;0;0;3;3
6;1;2;0;0;0;6;6
6;1;3;0;0;0;7;7
6;1;4;1;1;0;6;7
6;1;5;0;0;0;9;9
6;1;6;1;0;0;10;11
6;1;7;1;0;0;5;6
6;1;8;0;0;0;2;2
6;1;9;0;0;0;0;0
6;1;10;0;0;0;0;0
6;1;11;0;0;0;0;0
6;1;12;0;0;0;0;0
6;1;13;0;0;0;0;0
6;1;14;0;0;0;0;0
6;1;15;4;2;0;4;8
6;1;16;0;1;0;6;6
6;1;17;0;0;0;2;2
6;1;18;0;0;0;8;8
6;1;19;2;2;0;4;6
6;1;20;0;0;0;2;2
6;1;21;0;0;0;3;3
6;1;22;0;0;0;3;3
6;1;23;0;0;0;0;0
6;1;24;0;0;0;0;0
6;1;25;0;0;0;0;0
6;1;26;0;0;0;0;0
6;1;27;0;0;0;0;0
6;1;28;0;0;0;0;0
6;1;29;0;0;0;0;0
6;1;30;0;0;0;0;0
6;1;31;0;0;0;0;0
6;1;32;0;0;0;0;0
6;1;33;0;0;0;0;0
6;1;34;0;0;0;0;0
6;1;35;0;0;0;0;0
6;1;36;0;0;0;0;0
6;1;37;0;0;0;0;0
6;1;38;0;0;0;0;0
6;1;39;0;0;0;0;0
6;1;40;0;0;0;0;0
7;1;1;0;0;0;0;0
7;1;2;0;0;0;3;3
7;1;3;0;0;0;4;4
7;1;4;0;1;0;4;4
7;1;5;1;0;0;4;5
7;1;6;3;1;0;8;11
7;1;7;2;2;0;8;10
7;1;8;0;0;0;8;8
7;1;9;0;0;0;3;3
7;1;10;0;0;0;3;3
7;1;11;0;0;0;3;3
7;1;12;0;0;0;1;1
7;1;13;0;0;0;2;2
7;1;14;0;0;0;5;5
7;1;15;0;0;0;0;0
7;1;16;0;0;0;0;0
7;1;17;0;0;0;0;0
7;1;18;0;0;0;2;2
7;1;19;2;3;0;1;3
7;1;20;1;1;0;4;5
7;1;21;0;3;0;8;8
7;1;22;0;2;0;5;5
7;1;23;3;3;0;6;9
7;1;24;4;2;0;7;11
7;1;25;1;2;0;14;15
7;1;26;1;1;0;12;13
7;1;27;1;3;0;10;11
7;1;28;1;0;0;5;6
7;1;29;1;1;0;8;9
7;1;30;1;1;0;0;1
7;1;31;0;0;0;0;0
7;1;32;0;0;0;0;0
7;1;33;0;0;0;0;0
7;1;34;0;0;0;0;0
7;1;35;0;0;0;0;0
7;1;36;0;0;0;0;0
7;1;37;0;0;0;0;0
7;1;38;0;0;0;0;0
7;1;39;0;0;0;0;0
7;1;40;0;0;0;0;0
11;1;1;0;0;0;0;0
11;1;2;0;0;0;3;3
11;1;3;3;0;0;7;10
11;1;4;2;0;0;4;6
11;1;5;4;2;0;9;13
11;1;6;2;0;0;9;11
11;1;7;1;2;0;5;6
11;1;8;2;1;0;3;5
11;1;9;1;1;0;3;4
11;1;10;2;1;0;3;5
11;1;11;0;0;0;1;1
11;1;12;1;0;0;1;2
11;1;13;1;0;0;0;1
11;1;14;0;0;0;1;1
11;1;15;0;0;0;0;0
11;1;16;0;0;0;0;0
11;1;17;0;0;0;0;0
11;1;18;0;0;0;0;0
11;1;19;0;1;0;1;1
11;1;20;0;0;0;5;5
11;1;21;2;4;0;4;6
11;1;22;1;1;0;6;7
11;1;23;4;2;0;6;10
11;1;24;3;0;0;7;10
11;1;25;5;3;0;9;14
11;1;26;4;3;0;3;7
11;1;27;2;2;0;3;5
11;1;28;0;1;0;5;5
11;1;29;0;0;0;4;4
11;1;30;0;1;0;2;2
11;1;31;1;0;0;1;2
11;1;32;0;0;0;0;0
11;1;33;0;0;0;0;0
11;1;34;0;0;0;0;0
11;1;35;0;0;0;0;0
11;1;36;0;0;0;0;0
11;1;37;0;0;0;0;0
11;1;38;0;0;0;0;0
11;1;39;0;0;0;0;0
11;1;40;0;0;0;0;0
12;1;1;0;0;0;0;0
12;1;2;0;0;0;1;1
12;1;3;0;0;0;5;5
12;1;4;0;0;0;8;8
12;1;5;0;0;0;9;9
12;1;6;0;0;0;9;9
12;1;7;0;0;0;7;7
12;1;8;0;0;0;7;7
12;1;9;0;0;0;6;6
12;1;10;0;0;0;8;8
12;1;11;0;0;0;5;5
12;1;12;0;1;0;4;4
12;1;13;0;0;0;3;3
12;1;14;0;0;0;0;0
12;1;15;0;0;0;0;0
12;1;16;0;0;0;0;0
12;1;17;0;0;0;0;0
12;1;18;0;0;0;0;0
12;1;19;0;0;0;2;2
12;1;20;0;0;0;5;5
12;1;21;0;0;0;7;7
12;1;22;0;0;0;10;10
12;1;23;0;0;0;8;8
12;1;24;0;0;0;7;7
12;1;25;0;0;0;6;6
12;1;26;0;0;0;5;5
12;1;27;0;0;0;3;3
12;1;28;0;0;0;3;3
12;1;29;0;0;0;2;2
12;1;30;0;0;0;1;1
12;1;31;0;0;0;0;0
12;1;32;0;0;0;0;0
12;1;33;0;0;0;0;0
12;1;34;0;0;0;0;0
12;1;35;0;0;0;0;0
12;1;36;0;0;0;0;0
12;1;37;0;0;0;0;0
12;1;38;0;0;0;0;0
12;1;39;0;0;0;0;0
12;1;40;0;0;0;0;0
13;1;1;0;0;0;0;0
13;1;2;1;1;0;0;1
13;1;3;2;3;0;4;6
13;1;4;2;4;1;6;8
13;1;5;3;6;2;13;16
13;1;6;6;3;1;5;11
13;1;7;5;6;2;9;14
13;1;8;3;2;0;5;8
13;1;9;0;2;0;4;4
13;1;10;2;3;1;3;5
13;1;11;1;2;1;3;4
13;1;12;1;1;1;1;2
13;1;13;1;1;0;1;2
13;1;14;0;1;0;2;2
13;1;15;0;0;0;0;0
13;1;16;0;0;0;0;0
13;1;17;0;0;0;0;0
13;1;18;1;0;0;0;1
13;1;19;2;1;2;2;4
13;1;20;1;0;0;1;2
13;1;21;3;5;1;4;7
13;1;22;2;3;1;4;6
13;1;23;2;3;1;3;5
13;1;24;1;0;0;1;2
13;1;25;2;1;0;1;3
13;1;26;1;2;0;2;3
13;1;27;2;2;0;6;8
13;1;28;0;1;0;2;2
13;1;29;0;0;0;0;0
13;1;30;0;0;0;0;0
13;1;31;0;0;0;0;0
13;1;32;0;0;0;0;0
13;1;33;0;0;0;0;0
13;1;34;0;0;0;0;0
13;1;35;0;0;0;0;0
13;1;36;0;0;0;0;0
13;1;37;0;0;0;0;0
13;1;38;0;0;0;0;0
13;1;39;0;0;0;0;0
13;1;40;0;0;0;0;0
14;1;1;0;0;0;0;0
14;1;2;0;1;0;1;1
14;1;3;0;1;0;1;1
14;1;4;0;1;0;1;1
14;1;5;2;3;0;2;4
14;1;6;1;2;0;2;3
14;1;7;9;10;0;9;18
14;1;8;7;7;0;11;18
14;1;9;7;9;0;10;17
14;1;10;2;3;0;7;9
14;1;11;2;4;0;6;8
14;1;12;3;3;0;2;5
14;1;13;8;7;0;2;10
14;1;14;5;6;0;3;8
14;1;15;3;4;0;3;6
14;1;16;1;2;0;2;3
14;1;17;0;0;0;0;0
14;1;18;0;0;0;0;0
14;1;19;0;0;0;0;0
14;1;20;0;0;0;0;0
14;1;21;0;0;0;0;0
14;1;22;0;0;0;0;0
14;1;23;0;0;0;0;0
14;1;24;0;0;0;0;0
14;1;25;0;0;0;0;0
14;1;26;1;1;0;0;1
14;1;27;2;3;0;2;4
14;1;28;5;5;0;2;7
14;1;29;6;6;0;3;9
14;1;30;5;10;0;8;13
14;1;31;13;10;0;6;19
14;1;32;9;11;0;7;16
14;1;33;4;5;0;6;10
14;1;34;5;5;0;4;9
14;1;35;9;10;0;3;12
14;1;36;10;9;0;4;14
14;1;37;3;3;0;2;5
14;1;38;1;3;0;2;3
14;1;39;1;1;0;1;2
14;1;40;0;0;0;0;0
15;1;1;0;0;0;0;0
15;1;2;0;1;0;6;6
15;1;3;0;2;0;11;11
15;1;4;0;2;0;9;9
15;1;5;1;1;0;7;8
15;1;6;1;2;0;6;7
15;1;7;2;1;0;5;7
15;1;8;0;1;0;6;6
15;1;9;0;0;0;8;8
15;1;10;0;0;0;4;4
15;1;11;0;0;0;4;4
15;1;12;0;0;0;2;2
15;1;13;0;0;0;1;1
15;1;14;0;0;0;0;0
15;1;15;0;0;0;0;0
15;1;16;0;0;0;0;0
15;1;17;0;0;0;0;0
15;1;18;1;1;0;3;4
15;1;19;1;1;0;3;4
15;1;20;3;9;0;16;19
15;1;21;2;3;0;6;8
15;1;22;1;4;0;5;6
15;1;23;0;0;0;3;3
15;1;24;0;0;0;4;4
15;1;25;0;1;0;3;3
15;1;26;0;0;0;3;3
15;1;27;0;0;0;0;0
15;1;28;0;0;0;0;0
15;1;29;0;0;0;0;0
15;1;30;0;0;0;0;0
15;1;31;0;0;0;0;0
15;1;32;0;0;0;0;0
15;1;33;0;0;0;0;0
15;1;34;0;0;0;0;0
15;1;35;0;0;0;0;0
15;1;36;0;0;0;0;0
15;1;37;0;0;0;0;0
15;1;38;0;0;0;0;0
15;1;39;0;0;0;0;0
15;1;40;0;0;0;0;0
16;1;1;0;0;0;0;0
16;1;2;0;0;0;0;0
16;1;3;0;0;0;0;0
16;1;4;0;0;0;0;0
16;1;5;2;2;0;1;3
16;1;6;4;4;0;9;13
16;1;7;2;3;0;9;11
16;1;8;4;2;0;5;9
16;1;9;4;1;0;6;10
16;1;10;1;0;0;4;5
16;1;11;0;0;0;5;5
16;1;12;0;1;0;3;3
16;1;13;0;0;0;0;0
16;1;14;0;0;0;0;0
16;1;15;0;0;0;0;0
16;1;16;0;0;0;0;0
16;1;17;0;0;0;0;0
16;1;18;0;0;0;0;0
16;1;19;0;0;0;0;0
16;1;20;0;0;0;1;1
16;1;21;0;0;0;1;1
16;1;22;2;2;0;0;2
16;1;23;1;0;0;1;2
16;1;24;1;3;0;3;4
16;1;25;2;2;0;2;4
16;1;26;6;7;0;4;10
16;1;27;4;5;0;11;15
16;1;28;5;6;0;5;10
16;1;29;1;1;0;3;4
16;1;30;1;3;0;3;4
16;1;31;2;2;0;0;2
16;1;32;0;0;0;0;0
16;1;33;0;0;0;0;0
16;1;34;0;0;0;0;0
16;1;35;0;0;0;0;0
16;1;36;0;0;0;0;0
16;1;37;0;0;0;0;0
16;1;38;0;0;0;0;0
16;1;39;0;0;0;0;0
16;1;40;0;0;0;0;0
17;1;1;0;0;0;0;0
17;1;2;3;0;0;3;6
17;1;3;5;6;0;3;8
17;1;4;5;2;0;2;7
17;1;5;9;4;0;2;11
17;1;6;5;2;0;6;11
17;1;7;7;2;0;2;9
17;1;8;5;3;0;3;8
17;1;9;5;4;0;0;5
17;1;10;3;4;0;2;5
17;1;11;1;2;0;3;4
17;1;12;1;1;0;0;1
17;1;13;1;1;0;0;1
17;1;14;0;0;0;0;0
17;1;15;0;0;0;0;0
17;1;16;0;0;0;0;0
17;1;17;0;0;0;2;2
17;1;18;10;8;0;4;14
17;1;19;12;4;0;6;18
17;1;20;18;5;0;7;25
17;1;21;12;6;0;3;15
17;1;22;13;7;0;4;17
17;1;23;5;3;0;2;7
17;1;24;3;0;0;1;4
17;1;25;1;0;0;1;2
17;1;26;1;0;0;0;1
17;1;27;1;1;0;0;1
17;1;28;0;0;0;0;0
17;1;29;0;0;0;0;0
17;1;30;0;0;0;0;0
17;1;31;0;0;0;0;0
17;1;32;0;0;0;0;0
17;1;33;0;0;0;0;0
17;1;34;0;0;0;0;0
17;1;35;0;0;0;0;0
17;1;36;0;0;0;0;0
17;1;37;0;0;0;0;0
17;1;38;0;0;0;0;0
17;1;39;0;0;0;0;0
17;1;40;0;0;0;0;0
18;1;1;0;0;0;0;0
18;1;2;0;0;0;0;0
18;1;3;0;0;0;3;3
18;1;4;0;0;0;3;3
18;1;5;0;0;0;5;5
18;1;6;0;0;0;5;5
18;1;7;0;0;0;7;7
18;1;8;0;0;0;7;7
18;1;9;0;0;0;6;6
18;1;10;0;0;0;3;3
18;1;11;0;0;0;2;2
18;1;12;0;0;0;2;2
18;1;13;0;0;0;2;2
18;1;14;0;0;0;3;3
18;1;15;0;0;0;5;5
18;1;16;0;0;0;6;6
18;1;17;0;0;0;10;10
18;1;18;0;0;0;5;5
18;1;19;0;0;0;8;8
18;1;20;0;1;0;7;7
18;1;21;1;0;0;10;11
18;1;22;0;0;0;7;7
18;1;23;1;0;0;7;8
18;1;24;0;0;0;6;6
18;1;25;0;0;0;5;5
18;1;26;1;0;0;5;6
18;1;27;0;0;0;8;8
18;1;28;0;0;0;2;2
18;1;29;0;0;0;3;3
18;1;30;0;0;0;0;0
18;1;31;0;0;0;0;0
18;1;32;0;0;0;0;0
18;1;33;0;0;0;0;0
18;1;34;0;0;0;0;0
18;1;35;0;0;0;0;0
18;1;36;0;0;0;0;0
18;1;37;0;0;0;0;0
18;1;38;0;0;0;0;0
18;1;39;0;0;0;0;0
18;1;40;0;0;0;0;0
19;1;1;0;0;0;0;0
19;1;2;0;0;0;1;1
19;1;3;0;0;0;18;18
19;1;4;1;0;0;13;14
19;1;5;0;0;0;19;19
19;1;6;1;0;0;11;12
19;1;7;0;0;0;11;11
19;1;8;0;1;0;6;6
19;1;9;1;0;0;0;1
19;1;10;0;0;0;2;2
19;1;11;0;0;0;0;0
19;1;12;0;0;0;0;0
19;1;13;0;0;0;0;0
19;1;14;0;0;0;0;0
19;1;15;0;0;0;0;0
19;1;16;0;0;0;0;0
19;1;17;1;1;0;3;4
19;1;18;0;0;0;7;7
19;1;19;1;0;0;8;9
19;1;20;0;0;0;3;3
19;1;21;1;1;0;1;2
19;1;22;0;0;0;2;2
19;1;23;0;0;0;0;0
19;1;24;0;0;0;0;0
19;1;25;0;0;0;0;0
19;1;26;0;0;0;0;0
19;1;27;0;0;0;0;0
19;1;28;0;0;0;0;0
19;1;29;0;0;0;0;0
19;1;30;0;0;0;0;0
19;1;31;0;0;0;0;0
19;1;32;0;0;0;0;0
19;1;33;0;0;0;0;0
19;1;34;0;0;0;0;0
19;1;35;0;0;0;0;0
19;1;36;0;0;0;0;0
19;1;37;0;0;0;0;0
19;1;38;0;0;0;0;0
19;1;39;0;0;0;0;0
19;1;40;0;0;0;0;0
21;1;1;0;0;0;0;0
21;1;2;0;0;0;2;2
21;1;3;1;0;0;4;5
21;1;4;1;1;0;6;7
21;1;5;5;4;0;6;11
21;1;6;3;0;0;10;13
21;1;7;0;0;0;9;9
21;1;8;1;1;0;8;9
21;1;9;2;2;0;9;11
21;1;10;1;1;0;3;4
21;1;11;1;1;0;5;6
21;1;12;0;1;0;10;10
21;1;13;0;0;0;4;4
21;1;14;0;0;0;1;1
21;1;15;0;0;0;1;1
21;1;16;0;0;0;1;1
21;1;17;0;0;0;1;1
21;1;18;1;0;0;2;3
21;1;19;1;0;0;1;2
21;1;20;1;0;0;1;2
21;1;21;0;0;0;5;5
21;1;22;1;1;0;6;7
21;1;23;2;0;0;5;7
21;1;24;0;0;0;7;7
21;1;25;2;0;0;6;8
21;1;26;1;0;0;6;7
21;1;27;5;0;0;6;11
21;1;28;4;0;0;5;9
21;1;29;2;0;1;7;9
21;1;30;2;0;0;3;5
21;1;31;0;0;0;3;3
21;1;32;2;1;0;1;3
21;1;33;0;1;0;4;4
21;1;34;0;0;0;1;1
21;1;35;0;0;0;0;0
21;1;36;0;0;0;0;0
21;1;37;0;0;0;0;0
21;1;38;0;0;0;0;0
21;1;39;0;0;0;0;0
21;1;40;0;0;0;0;0
22;1;1;0;0;0;0;0
22;1;2;0;0;0;1;1
22;1;3;0;0;0;1;1
22;1;4;0;0;0;2;2
22;1;5;0;0;0;5;5
22;1;6;0;1;0;8;8
22;1;7;0;0;0;7;7
22;1;8;0;1;0;10;10
22;1;9;0;0;0;13;13
22;1;10;0;0;0;14;14
22;1;11;0;0;0;16;16
22;1;12;0;0;0;17;17
22;1;13;1;1;0;11;12
22;1;14;0;0;0;8;8
22;1;15;0;0;0;5;5
22;1;16;0;0;0;6;6
22;1;17;0;0;0;3;3
22;1;18;0;0;0;1;1
22;1;19;0;0;0;0;0
22;1;20;0;0;0;0;0
22;1;21;0;0;0;0;0
22;1;22;0;0;0;0;0
22;1;23;0;0;0;3;3
22;1;24;0;0;0;4;4
22;1;25;0;0;0;5;5
22;1;26;0;0;0;7;7
22;1;27;0;0;0;8;8
22;1;28;0;0;0;14;14
22;1;29;0;0;0;15;15
22;1;30;0;0;0;10;10
22;1;31;0;0;0;9;9
22;1;32;0;0;0;5;5
22;1;33;0;0;0;2;2
22;1;34;0;0;0;2;2
22;1;35;0;0;0;2;2
22;1;36;0;0;0;0;0
22;1;37;0;0;0;0;0
22;1;38;0;0;0;0;0
22;1;39;0;0;0;0;0
22;1;40;0;0;0;0;0
23;1;1;0;0;0;0;0
23;1;2;0;0;0;0;0
23;1;3;0;0;0;0;0
23;1;4;0;0;0;0;0
23;1;5;0;0;0;0;0
23;1;6;0;0;0;0;0
23;1;7;0;0;0;0;0
23;1;8;3;2;0;9;12
23;1;9;3;4;0;4;7
23;1;10;5;3;0;1;6
23;1;11;2;0;0;1;3
23;1;12;4;4;0;4;8
23;1;13;3;2;0;3;6
23;1;14;1;2;0;4;5
23;1;15;2;3;0;4;6
23;1;16;2;2;0;5;7
23;1;17;0;3;0;3;3
23;1;18;3;2;0;3;6
23;1;19;0;1;0;2;2
23;1;20;0;0;0;0;0
23;1;21;0;0;0;0;0
23;1;22;0;0;0;0;0
23;1;23;0;0;0;1;1
23;1;24;1;2;0;1;2
23;1;25;0;2;0;2;2
23;1;26;1;1;0;2;3
23;1;27;2;1;0;1;3
23;1;28;1;1;0;4;5
23;1;29;4;2;0;4;8
23;1;30;4;2;0;4;8
23;1;31;5;6;0;4;9
23;1;32;2;1;0;6;8
23;1;33;4;2;0;4;8
23;1;34;2;1;0;2;4
23;1;35;2;1;0;2;4
23;1;36;3;0;0;3;6
23;1;37;3;0;0;1;4
23;1;38;0;0;0;2;2
23;1;39;1;1;0;0;1
23;1;40;0;0;0;0;0
24;1;1;0;0;0;0;0
24;1;2;0;0;0;0;0
24;1;3;0;0;0;0;0
24;1;4;0;0;0;0;0
24;1;5;0;0;0;0;0
24;1;6;4;4;0;4;8
24;1;7;8;7;0;12;20
24;1;8;5;3;0;12;17
24;1;9;6;2;0;9;15
24;1;10;5;2;0;4;9
24;1;11;4;3;0;4;8
24;1;12;3;3;0;6;9
24;1;13;1;1;0;2;3
24;1;14;0;0;0;0;0
24;1;15;0;0;0;0;0
24;1;16;0;0;0;0;0
24;1;17;0;0;0;0;0
24;1;18;0;0;0;0;0
24;1;19;0;0;0;1;1
24;1;20;0;0;0;1;1
24;1;21;0;0;0;1;1
24;1;22;0;0;0;1;1
24;1;23;2;1;0;0;2
24;1;24;0;0;0;1;1
24;1;25;1;0;0;0;1
24;1;26;1;0;1;0;1
24;1;27;1;1;0;1;2
24;1;28;1;0;0;1;2
24;1;29;0;0;0;0;0
24;1;30;0;1;0;1;1
24;1;31;1;1;0;0;1
24;1;32;1;1;0;0;1
24;1;33;0;0;0;0;0
24;1;34;0;0;0;0;0
24;1;35;0;0;0;0;0
24;1;36;0;0;0;0;0
24;1;37;0;0;0;0;0
24;1;38;0;0;0;0;0
24;1;39;0;0;0;0;0
24;1;40;0;0;0;0;0
25;1;1;0;0;0;0;0
25;1;2;0;0;0;0;0
25;1;3;0;0;0;0;0
25;1;4;0;0;0;0;0
25;1;5;0;0;0;0;0
25;1;6;0;2;0;2;2
25;1;7;2;2;0;3;5
25;1;8;5;6;0;3;8
25;1;9;4;5;0;4;8
25;1;10;4;4;0;2;6
25;1;11;5;3;0;2;7
25;1;12;4;3;0;2;6
25;1;13;4;3;0;3;7
25;1;14;6;3;0;1;7
25;1;15;8;6;0;3;11
25;1;16;8;6;0;0;8
25;1;17;4;3;0;0;4
25;1;18;5;5;0;0;5
25;1;19;2;1;0;0;2
25;1;20;1;1;0;0;1
25;1;21;1;1;0;0;1
25;1;22;1;1;0;0;1
25;1;23;0;0;0;0;0
25;1;24;0;0;0;0;0
25;1;25;0;0;0;0;0
25;1;26;0;0;0;0;0
25;1;27;0;0;0;0;0
25;1;28;0;0;0;0;0
25;1;29;1;1;0;0;1
25;1;30;1;1;0;0;1
25;1;31;3;3;0;2;5
25;1;32;0;3;0;3;3
25;1;33;1;1;0;0;1
25;1;34;0;0;0;0;0
25;1;35;0;0;0;0;0
25;1;36;0;0;0;0;0
25;1;37;0;0;0;0;0
25;1;38;0;0;0;0;0
25;1;39;0;0;0;0;0
25;1;40;0;0;0;0;0
27;1;1;0;0;0;2;2
27;1;2;0;0;0;4;4
27;1;3;0;0;0;5;5
27;1;4;0;0;0;11;11
27;1;5;0;0;0;14;14
27;1;6;0;0;0;13;13
27;1;7;0;0;0;13;13
27;1;8;0;0;0;9;9
27;1;9;0;0;0;10;10
27;1;10;0;0;0;10;10
27;1;11;0;0;0;5;5
27;1;12;0;0;0;1;1
27;1;13;0;0;0;4;4
27;1;14;0;0;0;1;1
27;1;15;0;0;0;0;0
27;1;16;0;0;0;0;0
27;1;17;0;0;0;0;0
27;1;18;0;0;0;1;1
27;1;19;0;0;0;4;4
27;1;20;0;0;0;4;4
27;1;21;0;0;0;5;5
27;1;22;0;0;0;4;4
27;1;23;0;0;0;10;10
27;1;24;1;1;0;13;14
27;1;25;0;0;0;9;9
27;1;26;0;0;0;7;7
27;1;27;0;0;0;10;10
27;1;28;0;1;0;10;10
27;1;29;0;0;0;4;4
27;1;30;0;0;0;3;3
27;1;31;0;0;0;0;0
27;1;32;0;0;0;0;0
27;1;33;0;0;0;0;0
27;1;34;0;0;0;0;0
27;1;35;0;0;0;0;0
27;1;36;0;0;0;0;0
27;1;37;0;0;0;0;0
27;1;38;0;0;0;0;0
27;1;39;0;0;0;0;0
27;1;40;0;0;0;0;0
28;1;1;0;0;0;0;0
28;1;2;0;0;0;2;2
28;1;3;0;0;0;11;11
28;1;4;0;0;0;12;12
28;1;5;0;0;0;13;13
28;1;6;0;0;0;13;13
28;1;7;0;0;0;16;16
28;1;8;0;0;0;9;9
28;1;9;0;0;0;7;7
28;1;10;0;0;0;5;5
28;1;11;0;0;0;3;3
28;1;12;0;0;0;3;3
28;1;13;0;0;0;0;0
28;1;14;0;0;0;0;0
28;1;15;0;0;0;1;1
28;1;16;0;0;0;3;3
28;1;17;0;0;0;2;2
28;1;18;0;0;0;2;2
28;1;19;0;0;0;2;2
28;1;20;0;0;0;6;6
28;1;21;0;0;0;12;12
28;1;22;0;0;0;11;11
28;1;23;0;0;0;11;11
28;1;24;0;0;0;11;11
28;1;25;0;0;0;10;10
28;1;26;0;0;0;3;3
28;1;27;0;1;0;2;2
28;1;28;0;1;0;2;2
28;1;29;0;0;0;0;0
28;1;30;0;0;0;0;0
28;1;31;0;0;0;0;0
28;1;32;0;0;0;0;0
28;1;33;0;0;0;0;0
28;1;34;0;0;0;0;0
28;1;35;0;0;0;0;0
28;1;36;0;0;0;0;0
28;1;37;0;0;0;0;0
28;1;38;0;0;0;0;0
28;1;39;0;0;0;0;0
28;1;40;0;0;0;0;0
31;1;1;0;0;0;0;0
31;1;2;0;0;0;0;0
31;1;3;0;0;0;3;3
31;1;4;0;0;0;6;6
31;1;5;0;0;0;4;4
31;1;6;3;1;0;12;15
31;1;7;1;0;0;24;25
31;1;8;1;0;0;12;13
31;1;9;0;0;0;13;13
31;1;10;0;0;0;11;11
31;1;11;0;0;0;12;12
31;1;12;0;0;0;7;7
31;1;13;0;0;0;5;5
31;1;14;0;0;0;0;0
31;1;15;0;0;0;0;0
31;1;16;0;0;0;0;0
31;1;17;0;0;0;1;1
31;1;18;0;0;0;3;3
31;1;19;0;1;0;7;7
31;1;20;0;0;0;9;9
31;1;21;0;0;0;17;17
31;1;22;0;0;0;16;16
31;1;23;0;0;0;17;17
31;1;24;0;0;0;16;16
31;1;25;0;0;0;17;17
31;1;26;0;0;0;17;17
31;1;27;0;1;0;7;7
31;1;28;0;1;0;7;7
31;1;29;0;0;0;3;3
31;1;30;0;0;0;2;2
31;1;31;0;0;0;1;1
31;1;32;0;0;0;0;0
31;1;33;0;0;0;0;0
31;1;34;0;0;0;0;0
31;1;35;0;0;0;0;0
31;1;36;0;0;0;0;0
31;1;37;0;0;0;0;0
31;1;38;0;0;0;0;0
31;1;39;0;0;0;0;0
31;1;40;0;0;0;0;0
32;1;1;0;0;0;0;0
32;1;2;0;0;0;0;0
32;1;3;0;0;0;0;0
32;1;4;0;0;0;0;0
32;1;5;4;4;0;2;6
32;1;6;2;3;0;3;5
32;1;7;6;7;0;4;10
32;1;8;3;2;0;9;12
32;1;9;9;8;0;4;13
32;1;10;1;2;0;7;8
32;1;11;1;3;0;4;5
32;1;12;0;0;0;1;1
32;1;13;0;0;0;0;0
32;1;14;0;0;0;0;0
32;1;15;0;0;0;0;0
32;1;16;0;0;0;0;0
32;1;17;0;0;0;0;0
32;1;18;0;0;0;0;0
32;1;19;0;0;0;0;0
32;1;20;2;2;0;0;2
32;1;21;1;1;0;0;1
32;1;22;0;0;0;0;0
32;1;23;0;0;0;0;0
32;1;24;0;0;0;0;0
32;1;25;0;1;0;2;2
32;1;26;1;1;0;1;2
32;1;27;0;1;0;2;2
32;1;28;3;2;0;2;5
32;1;29;0;0;0;0;0
32;1;30;0;0;0;0;0
32;1;31;0;0;0;0;0
32;1;32;0;0;0;0;0
32;1;33;0;0;0;0;0
32;1;34;0;0;0;0;0
32;1;35;0;0;0;0;0
32;1;36;0;0;0;0;0
32;1;37;0;0;0;0;0
32;1;38;0;0;0;0;0
32;1;39;0;0;0;0;0
32;1;40;0;0;0;0;0
35;1;1;0;0;0;0;0
35;1;2;0;0;0;0;0
35;1;3;0;0;0;0;0
35;1;4;0;1;0;5;5
35;1;5;2;4;0;10;12
35;1;6;1;1;0;5;6
35;1;7;0;1;0;10;10
35;1;8;0;2;0;5;5
35;1;9;2;1;0;6;8
35;1;10;1;3;0;5;6
35;1;11;1;1;0;2;3
35;1;12;0;0;0;1;1
35;1;13;0;0;0;3;3
35;1;14;0;0;0;0;0
35;1;15;0;0;0;0;0
35;1;16;0;0;0;0;0
35;1;17;0;0;0;4;4
35;1;18;1;1;0;6;7
35;1;19;1;1;0;3;4
35;1;20;1;1;0;4;5
35;1;21;3;0;0;3;6
35;1;22;2;1;0;5;7
35;1;23;0;0;0;4;4
35;1;24;0;0;0;1;1
35;1;25;0;0;0;1;1
35;1;26;0;0;0;1;1
35;1;27;0;0;0;0;0
35;1;28;0;0;0;0;0
35;1;29;0;0;0;0;0
35;1;30;0;0;0;0;0
35;1;31;0;0;0;0;0
35;1;32;0;0;0;0;0
35;1;33;0;0;0;0;0
35;1;34;0;0;0;0;0
35;1;35;0;0;0;0;0
35;1;36;0;0;0;0;0
35;1;37;0;0;0;0;0
35;1;38;0;0;0;0;0
35;1;39;0;0;0;0;0
35;1;40;0;0;0;0;0
37;1;1;0;0;0;0;0
37;1;2;0;0;0;0;0
37;1;3;4;1;0;0;4
37;1;4;7;4;0;1;8
37;1;5;3;0;0;3;6
37;1;6;6;4;0;8;14
37;1;7;4;2;0;2;6
37;1;8;2;1;0;1;3
37;1;9;3;3;0;1;4
37;1;10;2;2;0;2;4
37;1;11;0;0;0;1;1
37;1;12;0;0;0;0;0
37;1;13;0;0;0;0;0
37;1;14;0;0;0;0;0
37;1;15;0;0;0;0;0
37;1;16;0;0;0;0;0
37;1;17;2;0;0;2;4
37;1;18;2;0;0;2;4
37;1;19;3;1;0;3;6
37;1;20;6;6;0;8;14
37;1;21;9;3;0;4;13
37;1;22;4;3;0;8;12
37;1;23;6;1;0;8;14
37;1;24;6;1;0;4;10
37;1;25;3;0;0;4;7
37;1;26;2;1;0;1;3
37;1;27;3;2;0;0;3
37;1;28;0;0;0;1;1
37;1;29;0;1;0;1;1
37;1;30;0;0;0;1;1
37;1;31;0;0;0;0;0
37;1;32;0;0;0;0;0
37;1;33;0;0;0;0;0
37;1;34;0;0;0;0;0
37;1;35;0;0;0;0;0
37;1;36;0;0;0;0;0
37;1;37;0;0;0;0;0
37;1;38;0;0;0;0;0
37;1;39;0;0;0;0;0
37;1;40;0;0;0;0;0
38;1;1;0;0;0;1;1
38;1;2;0;0;0;3;3
38;1;3;0;1;0;4;4
38;1;4;0;0;0;10;10
38;1;5;0;0;0;9;9
38;1;6;0;0;0;7;7
38;1;7;0;0;0;6;6
38;1;8;0;0;0;4;4
38;1;9;0;0;0;3;3
38;1;10;0;0;0;1;1
38;1;11;0;0;0;0;0
38;1;12;0;0;0;0;0
38;1;13;0;0;0;0;0
38;1;14;0;0;0;0;0
38;1;15;0;0;0;0;0
38;1;16;0;0;0;2;2
38;1;17;1;0;0;0;1
38;1;18;0;0;0;3;3
38;1;19;0;0;0;3;3
38;1;20;0;0;0;1;1
38;1;21;0;0;0;1;1
38;1;22;0;0;0;0;0
38;1;23;0;0;0;0;0
38;1;24;0;0;0;0;0
38;1;25;0;0;0;0;0
38;1;26;0;0;0;0;0
38;1;27;0;0;0;0;0
38;1;28;0;0;0;0;0
38;1;29;0;0;0;0;0
38;1;30;0;0;0;0;0
38;1;31;0;0;0;0;0
38;1;32;0;0;0;0;0
38;1;33;0;0;0;0;0
38;1;34;0;0;0;0;0
38;1;35;0;0;0;0;0
38;1;36;0;0;0;0;0
38;1;37;0;0;0;0;0
38;1;38;0;0;0;0;0
38;1;39;0;0;0;0;0
38;1;40;0;0;0;0;0
40;1;1;0;0;0;0;0
40;1;2;0;0;0;0;0
40;1;3;1;0;0;0;1
40;1;4;1;0;0;0;1
40;1;5;1;0;0;0;1
40;1;6;1;0;0;0;1
40;1;7;4;3;0;0;4
40;1;8;10;5;0;1;11
40;1;9;14;10;0;2;16
40;1;10;14;111;0;2;16
40;1;11;13;7;0;2;15
40;1;12;10;10;0;9;19
40;1;13;7;7;0;5;12
40;1;14;3;3;0;7;10
40;1;15;4;4;0;3;7
40;1;16;2;5;0;4;6
40;1;17;1;1;0;4;5
40;1;18;1;1;0;2;3
40;1;19;1;1;0;1;2
40;1;20;0;0;0;1;1
40;1;21;0;0;0;0;0
40;1;22;0;0;0;0;0
40;1;23;2;0;0;2;4
40;1;24;6;3;0;7;13
40;1;25;10;4;0;4;14
40;1;26;13;9;0;1;14
40;1;27;10;7;0;5;15
40;1;28;15;8;0;5;20
40;1;29;12;5;0;7;19
40;1;30;14;11;0;5;19
40;1;31;10;7;0;6;16
40;1;32;9;6;0;3;12
40;1;33;7;7;0;6;13
40;1;34;5;6;0;5;10
40;1;35;4;4;0;2;6
40;1;36;2;0;0;0;2
40;1;37;1;0;0;0;1
40;1;38;0;0;0;1;1
40;1;39;1;1;0;0;1
40;1;40;0;0;0;0;0
41;1;1;2;1;0;4;6
41;1;2;2;1;0;4;6
41;1;3;2;1;0;5;7
41;1;4;6;0;1;14;20
41;1;5;5;2;2;11;16
41;1;6;5;2;0;5;10
41;1;7;0;0;0;1;1
41;1;8;0;0;0;0;0
41;1;9;0;0;0;0;0
41;1;10;0;0;0;0;0
41;1;11;0;0;0;0;0
41;1;12;0;0;0;0;0
41;1;13;0;0;0;0;0
41;1;14;0;0;0;0;0
41;1;15;0;0;0;0;0
41;1;16;0;0;0;2;2
41;1;17;1;2;0;5;6
41;1;18;1;1;0;5;6
41;1;19;2;0;0;3;5
41;1;20;1;2;0;4;5
41;1;21;1;0;0;4;5
41;1;22;3;3;0;7;10
41;1;23;1;1;0;8;9
41;1;24;2;1;0;7;9
41;1;25;2;1;1;7;9
41;1;26;0;0;0;5;5
41;1;27;0;0;0;5;5
41;1;28;1;1;0;9;10
41;1;29;0;0;0;5;5
41;1;30;0;1;0;4;4
41;1;31;0;0;0;5;5
41;1;32;0;1;0;6;6
41;1;33;0;0;0;1;1
41;1;34;0;0;0;0;0
41;1;35;0;0;0;0;0
41;1;36;0;0;0;0;0
41;1;37;0;0;0;0;0
41;1;38;0;0;0;0;0
41;1;39;0;0;0;0;0
41;1;40;0;0;0;0;0
43;1;1;0;0;0;0;0
43;1;2;0;0;0;0;0
43;1;3;0;0;0;0;0
43;1;4;0;0;0;1;1
43;1;5;0;0;0;3;3
43;1;6;0;1;0;15;15
43;1;7;0;0;0;10;10
43;1;8;0;0;0;5;5
43;1;9;0;0;0;9;9
43;1;10;0;0;0;5;5
43;1;11;0;0;0;10;10
43;1;12;0;0;0;5;5
43;1;13;0;0;0;5;5
43;1;14;0;0;0;5;5
43;1;15;0;0;0;3;3
43;1;16;0;0;0;0;0
43;1;17;0;0;0;0;0
43;1;18;0;0;0;0;0
43;1;19;0;0;0;0;0
43;1;20;0;0;0;0;0
43;1;21;0;0;0;0;0
43;1;22;0;0;0;0;0
43;1;23;0;0;0;9;9
43;1;24;0;0;0;7;7
43;1;25;0;0;0;8;8
43;1;26;0;0;0;4;4
43;1;27;0;0;0;3;3
43;1;28;0;0;0;4;4
43;1;29;0;0;0;2;2
43;1;30;0;0;0;1;1
43;1;31;0;0;0;1;1
43;1;32;0;0;0;0;0
43;1;33;0;0;0;0;0
43;1;34;0;0;0;0;0
43;1;35;0;0;0;0;0
43;1;36;0;0;0;0;0
43;1;37;0;0;0;0;0
43;1;38;0;0;0;0;0
43;1;39;0;0;0;0;0
43;1;40;0;0;0;0;0
44;1;1;1;1;0;0;1
44;1;2;2;1;1;0;2
44;1;3;4;3;2;4;8
44;1;4;6;2;1;4;10
44;1;5;6;4;2;5;11
44;1;6;5;4;1;3;8
44;1;7;5;3;1;2;7
44;1;8;5;3;0;2;7
44;1;9;2;1;2;2;4
44;1;10;3;2;0;0;3
44;1;11;2;1;0;0;2
44;1;12;3;2;1;0;3
44;1;13;0;0;0;0;0
44;1;14;0;0;0;0;0
44;1;15;0;0;0;0;0
44;1;16;1;0;0;0;1
44;1;17;2;3;1;1;3
44;1;18;2;2;0;1;3
44;1;19;1;1;0;1;2
44;1;20;2;0;1;0;2
44;1;21;1;1;0;1;2
44;1;22;0;0;0;1;1
44;1;23;0;0;0;2;2
44;1;24;0;0;0;0;0
44;1;25;0;0;0;0;0
44;1;26;0;0;0;0;0
44;1;27;0;0;0;0;0
44;1;28;0;0;0;0;0
44;1;29;0;0;0;0;0
44;1;30;0;0;0;0;0
44;1;31;0;0;0;0;0
44;1;32;0;0;0;0;0
44;1;33;0;0;0;0;0
44;1;34;0;0;0;0;0
44;1;35;0;0;0;0;0
44;1;36;0;0;0;0;0
44;1;37;0;0;0;0;0
44;1;38;0;0;0;0;0
44;1;39;0;0;0;0;0
44;1;40;0;0;0;0;0
45;1;1;0;0;0;0;0
45;1;2;0;0;0;2;2
45;1;3;0;0;0;2;2
45;1;4;0;0;0;2;2
45;1;5;0;0;0;12;12
45;1;6;1;0;0;6;7
45;1;7;0;1;0;4;4
45;1;8;0;0;0;3;3
45;1;9;0;0;0;0;0
45;1;10;0;0;0;0;0
45;1;11;0;0;0;0;0
45;1;12;0;0;0;0;0
45;1;13;0;0;0;0;0
45;1;14;0;0;0;0;0
45;1;15;0;0;0;1;1
45;1;16;0;0;0;3;3
45;1;17;0;0;0;5;5
45;1;18;0;1;0;8;8
45;1;19;0;1;0;8;8
45;1;20;0;0;0;2;2
45;1;21;0;0;0;5;5
45;1;22;0;0;0;2;2
45;1;23;0;0;0;2;2
45;1;24;0;0;0;1;1
45;1;25;0;0;0;1;1
45;1;26;0;0;0;3;3
45;1;27;0;0;0;0;0
45;1;28;0;0;0;0;0
45;1;29;0;0;0;0;0
45;1;30;0;0;0;0;0
45;1;31;0;0;0;0;0
45;1;32;0;0;0;0;0
45;1;33;0;0;0;0;0
45;1;34;0;0;0;0;0
45;1;35;0;0;0;0;0
45;1;36;0;0;0;0;0
45;1;37;0;0;0;0;0
45;1;38;0;0;0;0;0
45;1;39;0;0;0;0;0
45;1;40;0;0;0;0;0
46;1;1;0;0;0;0;0
46;1;2;0;0;0;7;7
46;1;3;1;0;0;7;8
46;1;4;0;0;0;9;9
46;1;5;0;2;0;6;6
46;1;6;0;0;0;9;9
46;1;7;0;0;0;8;8
46;1;8;0;0;0;6;6
46;1;9;0;0;0;6;6
46;1;10;0;0;0;7;7
46;1;11;0;0;0;4;4
46;1;12;0;0;0;4;4
46;1;13;0;0;0;3;3
46;1;14;0;0;0;3;3
46;1;15;0;0;0;1;1
46;1;16;0;0;0;0;0
46;1;17;0;0;0;0;0
46;1;18;0;0;0;0;0
46;1;19;0;0;0;0;0
46;1;20;0;1;0;4;4
46;1;21;0;0;0;12;12
46;1;22;0;0;0;5;5
46;1;23;0;0;0;25;25
46;1;24;0;0;0;5;5
46;1;25;0;0;0;9;9
46;1;26;0;0;0;5;5
46;1;27;0;0;0;6;6
46;1;28;0;0;0;4;4
46;1;29;0;0;0;0;0
46;1;30;0;1;0;1;1
46;1;31;0;0;0;0;0
46;1;32;0;0;0;0;0
46;1;33;0;0;0;0;0
46;1;34;0;0;0;0;0
46;1;35;0;0;0;0;0
46;1;36;0;0;0;0;0
46;1;37;0;0;0;0;0
46;1;38;0;0;0;0;0
46;1;39;0;0;0;0;0
46;1;40;0;0;0;0;0
47;1;1;0;0;0;0;0
47;1;2;1;1;0;1;2
47;1;3;4;3;0;3;7
47;1;4;9;7;0;2;11
47;1;5;6;7;0;4;10
47;1;6;5;7;0;4;9
47;1;7;14;12;0;3;17
47;1;8;3;3;0;2;5
47;1;9;3;2;0;4;7
47;1;10;0;0;0;1;1
47;1;11;0;0;0;1;1
47;1;12;0;0;0;1;1
47;1;13;0;0;0;0;0
47;1;14;0;0;0;0;0
47;1;15;0;0;0;0;0
47;1;16;0;0;0;0;0
47;1;17;0;0;0;0;0
47;1;18;10;7;0;5;15
47;1;19;15;9;0;4;19
47;1;20;11;12;0;7;18
47;1;21;12;9;0;7;19
47;1;22;11;10;0;4;15
47;1;23;8;7;0;6;14
47;1;24;1;1;0;1;2
47;1;25;3;4;0;2;5
47;1;26;6;6;0;5;11
47;1;27;0;0;0;4;4
47;1;28;0;0;0;1;1
47;1;29;0;0;0;0;0
47;1;30;0;0;0;0;0
47;1;31;0;0;0;0;0
47;1;32;0;0;0;0;0
47;1;33;0;0;0;0;0
47;1;34;0;0;0;0;0
47;1;35;0;0;0;0;0
47;1;36;0;0;0;0;0
47;1;37;0;0;0;0;0
47;1;38;0;0;0;0;0
47;1;39;0;0;0;0;0
47;1;40;0;0;0;0;0
48;1;1;0;0;0;0;0
48;1;2;0;0;0;0;0
48;1;3;0;0;0;0;0
48;1;4;0;0;0;1;1
48;1;5;0;0;0;1;1
48;1;6;0;0;0;0;0
48;1;7;1;0;0;7;8
48;1;8;0;0;0;8;8
48;1;9;0;0;0;9;9
48;1;10;0;0;0;9;9
48;1;11;0;0;0;7;7
48;1;12;0;0;0;4;4
48;1;13;0;0;0;4;4
48;1;14;0;0;0;7;7
48;1;15;0;0;0;6;6
48;1;16;0;0;0;2;2
48;1;17;0;0;0;2;2
48;1;18;0;0;0;1;1
48;1;19;0;0;0;0;0
48;1;20;0;0;0;0;0
48;1;21;0;0;0;0;0
48;1;22;0;0;0;0;0
48;1;23;0;0;0;0;0
48;1;24;0;0;0;0;0
48;1;25;0;0;0;3;3
48;1;26;0;0;0;9;9
48;1;27;0;0;0;12;12
48;1;28;0;0;0;11;11
48;1;29;0;0;0;9;9
48;1;30;0;0;0;9;9
48;1;31;0;0;0;8;8
48;1;32;0;0;0;9;9
48;1;33;0;0;0;9;9
48;1;34;0;0;0;7;7
48;1;35;0;0;0;5;5
48;1;36;0;0;0;4;4
48;1;37;0;0;0;2;2
48;1;38;0;0;0;1;1
48;1;39;0;0;0;0;0
48;1;40;0;0;0;0;0
49;1;1;0;0;0;1;1
49;1;2;0;0;0;2;2
49;1;3;0;0;0;5;5
49;1;4;0;2;0;11;11
49;1;5;0;0;0;10;10
49;1;6;0;0;0;8;8
49;1;7;1;0;0;10;11
49;1;8;0;0;0;9;9
49;1;9;0;0;0;8;8
49;1;10;0;0;0;10;10
49;1;11;1;0;0;9;10
49;1;12;0;0;0;7;7
49;1;13;0;0;0;4;4
49;1;14;1;0;0;4;5
49;1;15;0;0;0;4;4
49;1;16;0;0;0;3;3
49;1;17;0;0;0;4;4
49;1;18;0;0;0;5;5
49;1;19;1;1;0;4;5
49;1;20;1;1;0;12;13
49;1;21;1;2;0;12;13
49;1;22;2;0;0;10;12
49;1;23;0;1;0;15;15
49;1;24;1;0;0;16;17
49;1;25;1;0;0;16;17
49;1;26;2;1;0;13;15
49;1;27;0;0;0;13;13
49;1;28;0;0;0;14;14
49;1;29;0;0;0;13;13
49;1;30;0;0;0;12;12
49;1;31;0;1;0;14;14
49;1;32;0;0;0;16;16
49;1;33;0;0;0;11;11
49;1;34;0;0;0;7;7
49;1;35;0;0;0;6;6
49;1;36;1;0;0;4;5
49;1;37;2;0;0;2;4
49;1;38;1;2;0;4;5
49;1;39;0;0;0;3;3
49;1;40;0;0;0;2;2
50;1;1;2;2;0;0;2
50;1;2;1;0;0;0;1
50;1;3;6;6;0;5;11
50;1;4;9;8;0;16;25
50;1;5;3;4;0;14;17
50;1;6;6;5;0;11;17
50;1;7;2;1;0;7;9
50;1;8;5;3;0;6;11
50;1;9;4;2;0;2;6
50;1;10;3;0;0;2;5
50;1;11;1;1;0;1;2
50;1;12;0;0;0;0;0
50;1;13;0;0;0;0;0
50;1;14;0;0;0;0;0
50;1;15;0;0;0;0;0
50;1;16;0;0;0;0;0
50;1;17;0;0;0;1;1
50;1;18;0;0;0;4;4
50;1;19;0;0;0;4;4
50;1;20;2;2;0;7;9
50;1;21;3;1;0;7;10
50;1;22;1;1;0;7;8
50;1;23;1;1;0;10;11
50;1;24;1;0;0;5;6
50;1;25;0;0;0;4;4
50;1;26;0;0;0;1;1
50;1;27;0;0;0;2;2
50;1;28;0;0;0;2;2
50;1;29;0;0;0;2;2
50;1;30;0;0;0;1;1
50;1;31;0;0;0;2;2
50;1;32;0;0;0;0;0
50;1;33;0;0;0;0;0
50;1;34;0;0;0;0;0
50;1;35;0;0;0;0;0
50;1;36;0;0;0;0;0
50;1;37;0;0;0;0;0
50;1;38;0;0;0;0;0
50;1;39;0;0;0;0;0
50;1;40;0;0;0;0;0
51;1;1;0;0;0;0;0
51;1;2;0;0;0;1;1
51;1;3;0;0;0;2;2
51;1;4;0;0;0;2;2
51;1;5;0;0;0;11;11
51;1;6;0;0;0;13;13
51;1;7;0;0;0;18;18
51;1;8;1;0;0;15;16
51;1;9;0;0;0;20;20
51;1;10;0;0;0;15;15
51;1;11;0;0;0;12;12
51;1;12;0;0;0;7;7
51;1;13;0;0;0;5;5
51;1;14;0;0;0;9;9
51;1;15;0;0;0;5;5
51;1;16;0;0;0;3;3
51;1;17;0;0;0;0;0
51;1;18;0;0;0;0;0
51;1;19;0;0;0;0;0
51;1;20;0;0;0;0;0
51;1;21;0;0;0;0;0
51;1;22;0;0;0;0;0
51;1;23;0;0;0;4;4
51;1;24;0;0;0;7;7
51;1;25;0;0;0;11;11
51;1;26;0;0;0;13;13
51;1;27;0;0;0;18;18
51;1;28;0;0;0;16;16
51;1;29;0;0;0;12;12
51;1;30;0;0;0;13;13
51;1;31;0;0;0;10;10
51;1;32;0;0;0;12;12
51;1;33;0;0;0;6;6
51;1;34;0;0;0;3;3
51;1;35;0;0;0;4;4
51;1;36;0;0;0;0;0
51;1;37;0;0;0;0;0
51;1;38;0;0;0;0;0
51;1;39;0;0;0;0;0
51;1;40;0;0;0;0;0
52;1;1;0;0;0;2;2
52;1;2;0;0;0;8;8
52;1;3;0;0;0;11;11
52;1;4;0;0;0;9;9
52;1;5;0;0;0;9;9
52;1;6;1;0;0;9;10
52;1;7;0;0;0;7;7
52;1;8;0;0;0;6;6
52;1;9;0;0;0;4;4
52;1;10;0;0;0;1;1
52;1;11;0;0;0;0;0
52;1;12;0;0;0;0;0
52;1;13;0;0;0;0;0
52;1;14;0;0;0;0;0
52;1;15;0;0;0;0;0
52;1;16;0;0;0;0;0
52;1;17;0;0;0;5;5
52;1;18;2;0;0;17;19
52;1;19;1;0;0;19;20
52;1;20;1;1;0;14;15
52;1;21;0;0;0;9;9
52;1;22;2;1;0;13;15
52;1;23;0;0;0;7;7
52;1;24;0;0;0;3;3
52;1;25;0;0;0;5;5
52;1;26;0;0;0;1;1
52;1;27;0;0;0;1;1
52;1;28;0;0;0;0;0
52;1;29;0;0;0;0;0
52;1;30;0;0;0;0;0
52;1;31;0;0;0;0;0
52;1;32;0;0;0;0;0
52;1;33;0;0;0;0;0
52;1;34;0;0;0;0;0
52;1;35;0;0;0;0;0
52;1;36;0;0;0;0;0
52;1;37;0;0;0;0;0
52;1;38;0;0;0;0;0
52;1;39;0;0;0;0;0
52;1;40;0;0;0;0;0
54;1;1;0;0;0;0;0
54;1;2;0;0;0;0;0
54;1;3;0;0;0;3;3
54;1;4;0;0;0;10;10
54;1;5;0;0;0;11;11
54;1;6;3;1;0;15;18
54;1;7;2;1;0;9;11
54;1;8;1;0;0;6;7
54;1;9;1;0;0;5;6
54;1;10;1;1;0;4;5
54;1;11;0;0;0;3;3
54;1;12;0;0;0;1;1
54;1;13;0;0;0;0;0
54;1;14;0;0;0;0;0
54;1;15;0;0;0;0;0
54;1;16;0;0;0;0;0
54;1;17;0;0;0;2;2
54;1;18;0;0;0;3;3
54;1;19;0;0;0;3;3
54;1;20;0;0;0;5;5
54;1;21;0;0;0;4;4
54;1;22;1;0;0;3;4
54;1;23;1;0;0;3;4
54;1;24;0;1;0;2;2
54;1;25;0;0;0;3;3
54;1;26;0;0;0;2;2
54;1;27;0;0;0;1;1
54;1;28;0;0;0;1;1
54;1;29;0;0;0;0;0
54;1;30;0;0;0;0;0
54;1;31;0;0;0;0;0
54;1;32;0;0;0;0;0
54;1;33;0;0;0;0;0
54;1;34;0;0;0;0;0
54;1;35;0;0;0;0;0
54;1;36;0;0;0;0;0
54;1;37;0;0;0;0;0
54;1;38;0;0;0;0;0
54;1;39;0;0;0;0;0
54;1;40;0;0;0;0;0
55;1;1;0;0;0;3;3
55;1;2;0;1;0;8;8
55;1;3;2;0;0;27;29
55;1;4;0;0;0;18;18
55;1;5;0;0;0;20;20
55;1;6;1;0;0;25;26
55;1;7;1;2;0;29;30
55;1;8;1;1;0;25;26
55;1;9;0;1;0;27;27
55;1;10;2;1;0;18;20
55;1;11;0;1;0;19;19
55;1;12;0;0;0;20;20
55;1;13;2;3;0;8;10
55;1;14;0;0;0;9;9
55;1;15;0;0;0;10;10
55;1;16;0;0;0;5;5
55;1;17;0;0;0;6;6
55;1;18;0;0;0;6;6
55;1;19;1;0;0;3;4
55;1;20;0;0;0;4;4
55;1;21;0;1;0;5;5
55;1;22;1;0;0;8;9
55;1;23;2;0;0;8;10
55;1;24;0;0;0;10;10
55;1;25;1;1;0;6;7
55;1;26;0;0;0;8;8
55;1;27;0;2;0;9;9
55;1;28;2;2;0;6;8
55;1;29;3;1;0;11;14
55;1;30;4;0;0;12;16
55;1;31;2;3;0;5;7
55;1;32;3;2;0;5;8
55;1;33;1;0;0;3;4
55;1;34;0;0;0;5;5
55;1;35;1;3;0;5;6
55;1;36;0;0;0;4;4
55;1;37;0;0;0;2;2
55;1;38;0;0;0;0;0
55;1;39;0;0;0;0;0
55;1;40;0;0;0;0;0
56;1;1;3;8;0;10;13
56;1;2;6;5;0;12;18
56;1;3;3;2;0;5;8
56;1;4;1;3;0;4;5
56;1;5;1;2;0;10;11
56;1;6;5;5;0;7;12
56;1;7;3;3;0;9;12
56;1;8;1;1;0;6;7
56;1;9;1;2;0;9;10
56;1;10;3;4;0;5;8
56;1;11;1;2;0;4;5
56;1;12;0;1;0;2;2
56;1;13;0;0;0;0;0
56;1;14;0;0;0;0;0
56;1;15;0;0;0;0;0
56;1;16;0;0;0;0;0
56;1;17;0;0;0;0;0
56;1;18;0;0;0;0;0
56;1;19;0;0;0;2;2
56;1;20;0;0;0;2;2
56;1;21;3;2;0;8;11
56;1;22;3;1;0;8;11
56;1;23;3;0;0;5;8
56;1;24;4;0;0;5;9
56;1;25;6;1;0;10;16
56;1;26;4;1;0;10;14
56;1;27;6;1;0;13;19
56;1;28;4;2;0;11;15
56;1;29;2;2;0;6;8
56;1;30;2;4;0;6;8
56;1;31;2;2;0;5;7
56;1;32;2;0;0;6;8
56;1;33;2;2;0;4;6
56;1;34;0;1;0;3;3
56;1;35;0;0;0;0;0
56;1;36;0;0;0;0;0
56;1;37;0;0;0;0;0
56;1;38;0;0;0;0;0
56;1;39;0;0;0;0;0
56;1;40;0;0;0;0;0
57;1;1;0;0;0;0;0
57;1;2;4;4;0;0;4
57;1;3;13;8;0;7;20
57;1;4;4;5;0;8;12
57;1;5;4;3;0;6;10
57;1;6;6;6;0;5;11
57;1;7;7;7;0;4;11
57;1;8;2;4;0;5;7
57;1;9;3;3;0;3;6
57;1;10;5;4;0;3;8
57;1;11;4;1;0;3;7
57;1;12;3;0;0;1;4
57;1;13;2;1;0;2;4
57;1;14;1;1;0;2;3
57;1;15;0;0;0;1;1
57;1;16;0;1;0;1;1
57;1;17;0;1;0;1;1
57;1;18;0;1;0;1;1
57;1;19;0;1;0;1;1
57;1;20;3;4;0;2;5
57;1;21;2;0;0;3;5
57;1;22;5;4;0;7;12
57;1;23;8;3;0;7;15
57;1;24;5;4;0;9;14
57;1;25;9;7;0;11;20
57;1;26;9;5;0;12;21
57;1;27;8;6;0;12;20
57;1;28;10;11;0;6;16
57;1;29;11;7;0;4;15
57;1;30;5;6;0;4;9
57;1;31;4;4;0;2;6
57;1;32;3;2;0;2;5
57;1;33;2;2;0;1;3
57;1;34;3;2;0;1;4
57;1;35;3;2;0;0;3
57;1;36;1;1;0;0;1
57;1;37;2;2;0;0;2
57;1;38;1;1;0;0;1
57;1;39;0;0;0;0;0
57;1;40;0;0;0;0;0
58;1;1;0;0;0;1;1
58;1;2;0;0;0;5;5
58;1;3;0;1;0;10;10
58;1;4;0;0;0;9;9
58;1;5;0;0;0;13;13
58;1;6;0;0;0;12;12
58;1;7;0;0;0;11;11
58;1;8;0;0;0;8;8
58;1;9;0;0;0;9;9
58;1;10;0;0;0;4;4
58;1;11;0;0;0;2;2
58;1;12;0;0;0;2;2
58;1;13;0;0;0;5;5
58;1;14;0;0;0;4;4
58;1;15;0;0;0;1;1
58;1;16;0;0;0;0;0
58;1;17;0;0;0;1;1
58;1;18;0;0;0;1;1
58;1;19;0;0;0;2;2
58;1;20;0;0;0;3;3
58;1;21;0;0;0;5;5
58;1;22;0;0;0;6;6
58;1;23;0;0;0;5;5
58;1;24;0;0;0;6;6
58;1;25;0;1;0;4;4
58;1;26;0;0;0;1;1
58;1;27;0;0;0;0;0
58;1;28;0;0;0;1;1
58;1;29;0;0;0;1;1
58;1;30;0;0;0;0;0
58;1;31;0;0;0;0;0
58;1;32;0;0;0;0;0
58;1;33;0;0;0;0;0
58;1;34;0;0;0;0;0
58;1;35;0;0;0;0;0
58;1;36;0;0;0;0;0
58;1;37;0;0;0;0;0
58;1;38;0;0;0;0;0
58;1;39;0;0;0;0;0
58;1;40;0;0;0;0;0
59;1;1;0;0;0;2;2
59;1;2;0;0;0;11;11
59;1;3;0;0;0;8;8
59;1;4;0;0;0;11;11
59;1;5;0;0;0;10;10
59;1;6;0;0;0;13;13
59;1;7;0;0;0;13;13
59;1;8;0;0;0;9;9
59;1;9;1;0;0;9;10
59;1;10;0;0;0;7;7
59;1;11;0;0;0;7;7
59;1;12;0;0;0;5;5
59;1;13;0;0;0;4;4
59;1;14;0;0;0;4;4
59;1;15;0;0;0;5;5
59;1;16;0;0;0;3;3
59;1;17;0;0;0;1;1
59;1;18;0;0;0;1;1
59;1;19;0;0;0;2;2
59;1;20;0;0;0;0;0
59;1;21;0;0;0;0;0
59;1;22;0;0;0;0;0
59;1;23;0;0;0;0;0
59;1;24;0;0;0;6;6
59;1;25;0;0;0;14;14
59;1;26;3;0;1;33;36
59;1;27;0;1;0;21;21
59;1;28;0;0;0;15;15
59;1;29;0;0;0;7;7
59;1;30;0;0;0;3;3
59;1;31;0;0;0;1;1
59;1;32;0;0;0;0;0
59;1;33;0;0;0;0;0
59;1;34;0;0;0;0;0
59;1;35;0;0;0;0;0
59;1;36;0;0;0;0;0
59;1;37;0;0;0;0;0
59;1;38;0;0;0;0;0
59;1;39;0;0;0;0;0
59;1;40;0;0;0;0;0
62;1;1;0;0;0;0;0
62;1;2;0;0;0;0;0
62;1;3;0;0;0;1;1
62;1;4;0;0;0;1;1
62;1;5;1;2;0;4;5
62;1;6;2;2;0;5;7
62;1;7;1;0;0;8;9
62;1;8;2;5;0;9;11
62;1;9;2;3;0;11;13
62;1;10;7;8;0;16;23
62;1;11;10;13;0;21;31
62;1;12;11;11;0;17;28
62;1;13;6;8;0;22;28
62;1;14;11;14;0;18;29
62;1;15;6;9;0;13;19
62;1;16;4;9;0;12;16
62;1;17;6;7;0;9;15
62;1;18;0;1;0;7;7
62;1;19;4;5;0;3;7
62;1;20;3;3;0;2;5
62;1;21;0;0;0;2;2
62;1;22;0;0;0;1;1
62;1;23;0;0;0;2;2
62;1;24;0;0;0;0;0
62;1;25;0;0;0;1;1
62;1;26;0;0;0;3;3
62;1;27;0;0;0;8;8
62;1;28;1;0;0;11;12
62;1;29;2;2;0;12;14
62;1;30;5;4;0;11;16
62;1;31;5;3;0;6;11
62;1;32;4;5;0;10;14
62;1;33;3;4;0;7;10
62;1;34;4;5;0;5;9
62;1;35;4;4;0;4;8
62;1;36;3;4;0;8;11
62;1;37;2;1;0;3;5
62;1;38;1;1;0;1;2
62;1;39;0;1;0;2;2
62;1;40;0;0;0;1;1
63;1;1;0;0;0;0;0
63;1;2;0;0;0;5;5
63;1;3;0;1;0;18;18
63;1;4;0;1;0;15;15
63;1;5;0;2;0;12;12
63;1;6;0;1;0;12;12
63;1;7;0;1;0;24;24
63;1;8;0;0;0;16;16
63;1;9;0;0;0;7;7
63;1;10;0;0;0;6;6
63;1;11;0;0;0;4;4
63;1;12;0;0;0;3;3
63;1;13;0;0;0;2;2
63;1;14;0;0;0;1;1
63;1;15;0;0;0;0;0
63;1;16;0;0;0;3;3
63;1;17;0;0;0;4;4
63;1;18;0;1;0;18;18
63;1;19;0;0;0;19;19
63;1;20;0;1;0;8;8
63;1;21;0;0;0;9;9
63;1;22;0;1;0;8;8
63;1;23;0;0;0;5;5
63;1;24;0;1;0;3;3
63;1;25;0;0;0;2;2
63;1;26;1;1;0;1;2
63;1;27;0;1;0;1;1
63;1;28;0;0;0;1;1
63;1;29;0;0;0;1;1
63;1;30;0;0;0;0;0
63;1;31;0;0;0;0;0
63;1;32;0;0;0;0;0
63;1;33;0;0;0;0;0
63;1;34;0;0;0;0;0
63;1;35;0;0;0;0;0
63;1;36;0;0;0;0;0
63;1;37;0;0;0;0;0
63;1;38;0;0;0;0;0
63;1;39;0;0;0;0;0
63;1;40;0;0;0;0;0
64;1;1;0;0;0;0;0
64;1;2;0;0;0;2;2
64;1;3;0;2;0;10;10
64;1;4;0;0;0;9;9
64;1;5;0;1;0;11;11
64;1;6;1;1;0;13;14
64;1;7;2;0;0;8;10
64;1;8;0;1;0;7;7
64;1;9;0;1;0;4;4
64;1;10;0;0;0;3;3
64;1;11;0;0;0;1;1
64;1;12;0;0;0;2;2
64;1;13;0;0;0;2;2
64;1;14;0;0;0;0;0
64;1;15;0;0;0;0;0
64;1;16;0;0;0;0;0
64;1;17;0;0;0;0;0
64;1;18;0;0;0;1;1
64;1;19;0;0;0;14;14
64;1;20;1;1;0;15;16
64;1;21;1;1;0;17;18
64;1;22;2;0;0;20;22
64;1;23;2;0;0;16;18
64;1;24;1;0;0;12;13
64;1;25;0;0;0;7;7
64;1;26;2;0;0;5;7
64;1;27;0;0;0;1;1
64;1;28;0;0;0;0;0
64;1;29;0;0;0;0;0
64;1;30;0;0;0;0;0
64;1;31;0;0;0;0;0
64;1;32;0;0;0;0;0
64;1;33;0;0;0;0;0
64;1;34;0;0;0;0;0
64;1;35;0;0;0;0;0
64;1;36;0;0;0;0;0
64;1;37;0;0;0;0;0
64;1;38;0;0;0;0;0
64;1;39;0;0;0;0;0
64;1;40;0;0;0;0;0
66;1;1;0;0;0;0;0
66;1;2;3;1;0;7;10
66;1;3;4;2;0;6;10
66;1;4;4;1;0;8;12
66;1;5;5;4;0;4;9
66;1;6;3;1;0;5;8
66;1;7;2;2;0;5;7
66;1;8;3;1;0;4;7
66;1;9;1;1;0;4;5
66;1;10;2;1;0;1;3
66;1;11;0;0;0;1;1
66;1;12;0;0;0;0;0
66;1;13;0;0;0;0;0
66;1;14;0;0;0;0;0
66;1;15;0;0;0;0;0
66;1;16;0;0;0;0;0
66;1;17;0;0;0;1;1
66;1;18;4;3;0;3;7
66;1;19;6;3;0;5;11
66;1;20;9;6;0;8;17
66;1;21;9;2;0;5;14
66;1;22;3;1;0;6;9
66;1;23;7;2;0;4;11
66;1;24;9;7;0;2;11
66;1;25;4;2;0;2;6
66;1;26;4;0;0;2;6
66;1;27;3;1;0;2;5
66;1;28;2;0;0;1;3
66;1;29;1;1;0;1;2
66;1;30;0;0;0;0;0
66;1;31;0;0;0;0;0
66;1;32;0;0;0;0;0
66;1;33;0;0;0;0;0
66;1;34;0;0;0;0;0
66;1;35;0;0;0;0;0
66;1;36;0;0;0;0;0
66;1;37;0;0;0;0;0
66;1;38;0;0;0;0;0
66;1;39;0;0;0;0;0
66;1;40;0;0;0;0;0
68;1;1;0;0;0;0;0
68;1;2;0;0;0;0;0
68;1;3;0;0;0;4;4
68;1;4;0;0;0;17;17
68;1;5;0;0;0;11;11
68;1;6;0;0;0;16;16
68;1;7;0;0;0;9;9
68;1;8;0;0;0;13;13
68;1;9;0;0;0;12;12
68;1;10;0;0;0;12;12
68;1;11;0;0;0;8;8
68;1;12;0;0;0;8;8
68;1;13;0;0;0;14;14
68;1;14;0;0;0;14;14
68;1;15;0;0;0;9;9
68;1;16;3;0;0;10;13
68;1;17;2;1;0;8;10
68;1;18;0;0;0;11;11
68;1;19;0;0;0;15;15
68;1;20;0;0;0;21;21
68;1;21;0;0;0;17;17
68;1;22;0;0;0;25;25
68;1;23;0;0;0;21;21
68;1;24;0;0;0;14;14
68;1;25;0;0;0;11;11
68;1;26;1;2;0;11;12
68;1;27;0;0;0;7;7
68;1;28;0;0;0;7;7
68;1;29;0;0;0;6;6
68;1;30;0;0;0;5;5
68;1;31;0;0;0;5;5
68;1;32;0;0;0;6;6
68;1;33;0;1;0;2;2
68;1;34;0;0;0;0;0
68;1;35;0;0;0;0;0
68;1;36;0;0;0;0;0
68;1;37;0;0;0;0;0
68;1;38;0;0;0;0;0
68;1;39;0;0;0;0;0
68;1;40;0;0;0;0;0
70;1;1;0;0;0;0;0
70;1;2;0;0;0;3;3
70;1;3;0;0;0;9;9
70;1;4;1;1;0;6;7
70;1;5;1;1;0;7;8
70;1;6;0;0;0;6;6
70;1;7;0;0;0;6;6
70;1;8;0;0;0;5;5
70;1;9;1;1;0;2;3
70;1;10;0;0;0;3;3
70;1;11;0;0;0;3;3
70;1;12;1;1;0;1;2
70;1;13;1;1;0;2;3
70;1;14;0;0;0;1;1
70;1;15;0;0;0;1;1
70;1;16;0;0;0;0;0
70;1;17;0;0;0;0;0
70;1;18;0;0;0;0;0
70;1;19;1;0;0;2;3
70;1;20;2;3;0;3;5
70;1;21;0;0;0;8;8
70;1;22;3;3;0;7;10
70;1;23;5;4;0;4;9
70;1;24;2;2;0;5;7
70;1;25;1;2;0;8;9
70;1;26;2;5;0;10;12
70;1;27;3;1;0;10;13
70;1;28;1;1;0;8;9
70;1;29;0;0;0;8;8
70;1;30;0;1;0;4;4
70;1;31;0;0;0;0;0
70;1;32;0;0;0;0;0
70;1;33;0;0;0;0;0
70;1;34;0;0;0;0;0
70;1;35;0;0;0;0;0
70;1;36;0;0;0;0;0
70;1;37;0;0;0;0;0
70;1;38;0;0;0;0;0
70;1;39;0;0;0;0;0
70;1;40;0;0;0;0;0
71;1;1;0;0;0;2;2
71;1;2;0;0;0;3;3
71;1;3;0;0;0;4;4
71;1;4;0;0;0;4;4
71;1;5;0;0;0;6;6
71;1;6;0;1;0;10;10
71;1;7;0;0;0;8;8
71;1;8;0;0;0;9;9
71;1;9;1;0;0;6;7
71;1;10;1;0;0;7;8
71;1;11;0;1;0;9;9
71;1;12;0;2;0;10;10
71;1;13;0;0;0;4;4
71;1;14;0;0;0;4;4
71;1;15;0;0;0;2;2
71;1;16;0;0;0;1;1
71;1;17;0;0;0;2;2
71;1;18;0;0;0;2;2
71;1;19;0;0;0;1;1
71;1;20;0;0;0;0;0
71;1;21;0;0;0;0;0
71;1;22;0;0;0;0;0
71;1;23;0;0;0;0;0
71;1;24;0;0;0;0;0
71;1;25;0;0;0;0;0
71;1;26;0;0;0;1;1
71;1;27;0;0;0;4;4
71;1;28;0;0;0;4;4
71;1;29;0;0;0;4;4
71;1;30;0;0;0;4;4
71;1;31;0;0;0;6;6
71;1;32;0;0;0;6;6
71;1;33;0;0;0;5;5
71;1;34;0;0;0;6;6
71;1;35;0;1;0;8;8
71;1;36;0;0;0;5;5
71;1;37;0;0;0;4;4
71;1;38;0;1;0;3;3
71;1;39;0;0;0;2;2
71;1;40;0;0;0;1;1
72;1;1;1;0;0;11;12
72;1;2;1;0;0;8;9
72;1;3;2;0;0;6;8
72;1;4;2;0;0;5;7
72;1;5;3;0;0;5;8
72;1;6;2;0;0;6;8
72;1;7;2;0;0;10;12
72;1;8;2;0;0;7;9
72;1;9;0;0;0;6;6
72;1;10;0;0;0;5;5
72;1;11;1;0;0;5;6
72;1;12;2;0;0;4;6
72;1;13;0;0;0;3;3
72;1;14;0;0;0;2;2
72;1;15;0;0;0;2;2
72;1;16;0;0;0;2;2
72;1;17;0;0;0;2;2
72;1;18;0;0;0;1;1
72;1;19;1;0;0;2;3
72;1;20;0;0;0;1;1
72;1;21;0;0;0;2;2
72;1;22;0;0;0;0;0
72;1;23;0;0;0;0;0
72;1;24;0;0;0;0;0
72;1;25;1;0;0;1;2
72;1;26;0;0;0;2;2
72;1;27;1;0;0;2;3
72;1;28;0;0;0;3;3
72;1;29;1;0;0;7;8
72;1;30;2;1;0;6;8
72;1;31;0;0;0;5;5
72;1;32;0;0;0;1;1
72;1;33;0;0;0;2;2
72;1;34;0;0;0;2;2
72;1;35;0;0;0;0;0
72;1;36;0;0;0;0;0
72;1;37;0;0;0;0;0
72;1;38;0;0;0;0;0
72;1;39;0;0;0;0;0
72;1;40;0;0;0;0;0
73;1;1;0;0;0;0;0
73;1;2;0;0;0;2;2
73;1;3;2;1;0;6;8
73;1;4;1;0;0;6;7
73;1;5;1;0;0;8;9
73;1;6;0;0;0;8;8
73;1;7;0;0;0;13;13
73;1;8;0;0;0;8;8
73;1;9;0;0;0;7;7
73;1;10;0;0;0;7;7
73;1;11;0;0;0;6;6
73;1;12;0;0;0;5;5
73;1;13;0;0;0;4;4
73;1;14;0;0;0;4;4
73;1;15;0;0;0;4;4
73;1;16;0;0;0;3;3
73;1;17;0;0;0;2;2
73;1;18;0;0;0;1;1
73;1;19;0;0;0;2;2
73;1;20;0;0;0;2;2
73;1;21;0;0;0;1;1
73;1;22;0;0;0;4;4
73;1;23;0;0;0;6;6
73;1;24;0;0;0;8;8
73;1;25;1;0;0;5;6
73;1;26;0;0;0;4;4
73;1;27;0;0;0;5;5
73;1;28;0;0;0;6;6
73;1;29;0;0;0;4;4
73;1;30;1;2;0;3;4
73;1;31;0;0;0;4;4
73;1;32;0;0;0;1;1
73;1;33;0;0;0;0;0
73;1;34;0;0;0;0;0
73;1;35;0;0;0;0;0
73;1;36;0;0;0;0;0
73;1;37;0;0;0;0;0
73;1;38;0;0;0;0;0
73;1;39;0;0;0;0;0
73;1;40;0;0;0;0;0
75;1;1;0;0;0;2;2
75;1;2;0;0;0;2;2
75;1;3;1;0;0;3;4
75;1;4;0;0;0;3;3
75;1;5;1;0;0;2;3
75;1;6;0;1;0;13;13
75;1;7;3;3;0;11;14
75;1;8;2;3;0;8;10
75;1;9;0;0;0;3;3
75;1;10;0;0;0;3;3
75;1;11;0;0;0;2;2
75;1;12;0;0;0;2;2
75;1;13;0;0;0;1;1
75;1;14;0;0;0;1;1
75;1;15;0;0;0;1;1
75;1;16;0;0;0;1;1
75;1;17;0;0;0;0;0
75;1;18;0;0;0;0;0
75;1;19;1;0;0;0;1
75;1;20;1;1;0;0;1
75;1;21;1;1;0;1;2
75;1;22;1;1;0;2;3
75;1;23;0;1;0;4;4
75;1;24;0;2;0;5;5
75;1;25;1;2;0;4;5
75;1;26;1;0;0;4;5
75;1;27;2;0;0;3;5
75;1;28;0;1;0;3;3
75;1;29;0;2;0;5;5
75;1;30;0;0;0;2;2
75;1;31;0;0;0;1;1
75;1;32;0;1;0;1;1
75;1;33;0;1;0;1;1
75;1;34;0;0;0;0;0
75;1;35;0;0;0;0;0
75;1;36;0;0;0;0;0
75;1;37;0;0;0;0;0
75;1;38;0;0;0;0;0
75;1;39;0;0;0;0;0
75;1;40;0;0;0;0;0
76;1;1;0;0;0;0;0
76;1;2;0;0;0;0;0
76;1;3;0;0;0;1;1
76;1;4;0;0;0;17;17
76;1;5;0;0;0;27;27
76;1;6;0;0;0;30;30
76;1;7;0;0;0;17;17
76;1;8;0;0;0;16;16
76;1;9;0;0;0;14;14
76;1;10;0;0;0;13;13
76;1;11;0;0;0;7;7
76;1;12;0;0;0;2;2
76;1;13;0;0;0;0;0
76;1;14;0;0;0;0;0
76;1;15;0;0;0;0;0
76;1;16;0;0;0;3;3
76;1;17;0;0;0;3;3
76;1;18;0;0;0;3;3
76;1;19;0;0;0;4;4
76;1;20;0;1;0;4;4
76;1;21;0;0;0;11;11
76;1;22;0;0;0;8;8
76;1;23;0;1;0;11;11
76;1;24;0;0;0;7;7
76;1;25;0;0;0;6;6
76;1;26;0;0;0;8;8
76;1;27;0;0;0;10;10
76;1;28;0;0;0;8;8
76;1;29;0;0;0;1;1
76;1;30;0;0;0;1;1
76;1;31;0;0;0;3;3
76;1;32;0;0;0;2;2
76;1;33;0;0;0;2;2
76;1;34;0;0;0;3;3
76;1;35;0;0;0;2;2
76;1;36;0;0;0;1;1
76;1;37;0;0;0;1;1
76;1;38;0;0;0;0;0
76;1;39;0;0;0;0;0
76;1;40;0;0;0;0;0
78;1;1;0;0;0;0;0
78;1;2;0;0;0;0;0
78;1;3;0;0;0;1;1
78;1;4;1;0;0;2;3
78;1;5;0;0;0;6;6
78;1;6;0;0;0;10;10
78;1;7;0;0;0;14;14
78;1;8;0;0;0;18;18
78;1;9;0;0;0;18;18
78;1;10;0;0;0;16;16
78;1;11;0;0;0;13;13
78;1;12;0;0;0;13;13
78;1;13;0;0;0;10;10
78;1;14;0;0;0;11;11
78;1;15;0;0;0;9;9
78;1;16;0;0;0;5;5
78;1;17;0;0;0;5;5
78;1;18;0;0;0;3;3
78;1;19;0;0;0;1;1
78;1;20;0;0;0;0;0
78;1;21;0;0;0;4;4
78;1;22;0;0;0;3;3
78;1;23;0;0;0;3;3
78;1;24;0;0;0;5;5
78;1;25;2;0;0;15;17
78;1;26;1;0;0;25;26
78;1;27;2;0;0;19;21
78;1;28;2;1;0;21;23
78;1;29;0;0;0;19;19
78;1;30;1;1;0;18;19
78;1;31;1;0;0;13;14
78;1;32;0;1;0;13;13
78;1;33;0;1;0;8;8
78;1;34;0;0;0;8;8
78;1;35;0;0;0;4;4
78;1;36;0;0;0;5;5
78;1;37;0;0;0;1;1
78;1;38;0;0;0;0;0
78;1;39;0;0;0;0;0
78;1;40;0;0;0;0;0
79;1;1;0;0;0;0;0
79;1;2;0;0;0;0;0
79;1;3;0;0;0;1;1
79;1;4;0;0;0;1;1
79;1;5;0;0;0;8;8
79;1;6;0;0;0;8;8
79;1;7;0;0;0;9;9
79;1;8;0;1;0;10;10
79;1;9;0;1;0;10;10
79;1;10;1;1;0;7;8
79;1;11;1;0;0;6;7
79;1;12;1;0;0;6;7
79;1;13;1;0;0;8;9
79;1;14;0;0;0;7;7
79;1;15;1;0;0;5;6
79;1;16;3;0;0;6;9
79;1;17;0;0;0;7;7
79;1;18;0;0;0;7;7
79;1;19;2;0;0;6;8
79;1;20;1;1;0;6;7
79;1;21;1;0;0;6;7
79;1;22;0;0;0;1;1
79;1;23;0;0;0;1;1
79;1;24;0;1;0;1;1
79;1;25;0;0;0;0;0
79;1;26;0;0;0;1;1
79;1;27;0;0;0;1;1
79;1;28;0;1;0;2;2
79;1;29;0;0;0;4;4
79;1;30;0;0;0;7;7
79;1;31;1;0;0;6;7
79;1;32;0;0;0;6;6
79;1;33;2;3;0;7;9
79;1;34;1;1;0;13;14
79;1;35;0;0;0;7;7
79;1;36;0;0;0;6;6
79;1;37;0;1;0;5;5
79;1;38;1;1;0;4;5
79;1;39;0;0;0;1;1
79;1;40;0;0;0;0;0
81;1;1;0;0;0;0;0
81;1;2;0;0;0;0;0
81;1;3;0;0;0;0;0
81;1;4;0;0;0;7;7
81;1;5;0;0;0;5;5
81;1;6;0;0;0;6;6
81;1;7;0;0;0;10;10
81;1;8;0;0;0;7;7
81;1;9;0;0;0;10;10
81;1;10;2;0;0;6;8
81;1;11;0;0;0;8;8
81;1;12;0;0;0;6;6
81;1;13;0;0;0;3;3
81;1;14;0;0;0;2;2
81;1;15;0;0;0;4;4
81;1;16;0;0;0;2;2
81;1;17;0;0;0;1;1
81;1;18;0;0;0;1;1
81;1;19;0;0;0;3;3
81;1;20;1;0;0;1;2
81;1;21;1;0;0;2;3
81;1;22;0;0;0;1;1
81;1;23;0;0;0;2;2
81;1;24;0;0;0;0;0
81;1;25;0;0;0;0;0
81;1;26;0;0;0;0;0
81;1;27;0;0;0;5;5
81;1;28;0;0;0;10;10
81;1;29;1;0;0;14;15
81;1;30;1;0;0;14;15
81;1;31;0;0;0;11;11
81;1;32;0;0;0;13;13
81;1;33;3;0;0;9;12
81;1;34;1;0;0;7;8
81;1;35;1;0;0;8;9
81;1;36;1;0;0;6;7
81;1;37;2;0;1;4;6
81;1;38;0;0;0;1;1
81;1;39;0;0;0;1;1
81;1;40;0;0;0;0;0
9;1;1;0;0;0;1;1
9;1;2;1;0;0;3;4
9;1;3;0;1;0;6;6
9;1;4;0;0;0;7;7
9;1;5;2;2;0;7;9
9;1;6;0;1;0;16;16
9;1;7;4;2;0;13;17
9;1;8;2;1;0;11;13
9;1;9;2;2;0;6;8
9;1;10;1;1;0;5;6
9;1;11;1;1;0;7;8
9;1;12;1;0;0;10;11
9;1;13;0;1;0;15;15
9;1;14;0;0;0;8;8
9;1;15;1;1;0;6;7
9;1;16;0;0;0;3;3
9;1;17;0;0;0;2;2
9;1;18;0;0;0;2;2
9;1;19;0;0;0;3;3
9;1;20;0;0;0;0;0
10;1;1;0;0;0;0;0
10;1;2;0;0;0;0;0
10;1;3;0;0;0;0;0
10;1;4;0;0;0;5;5
10;1;5;0;0;0;15;15
10;1;6;0;0;0;17;17
10;1;7;0;0;0;20;20
10;1;8;0;0;0;7;7
10;1;9;0;0;0;6;6
10;1;10;0;0;0;5;5
10;1;11;0;0;0;4;4
10;1;12;0;0;0;4;4
10;1;13;0;0;0;6;6
10;1;14;0;0;0;5;5
10;1;15;0;0;0;5;5
10;1;16;0;0;0;1;1
10;1;17;0;0;0;0;0
10;1;18;0;0;0;0;0
10;1;19;0;0;0;0;0
10;1;20;0;0;0;0;0
20;1;1;0;0;0;3;3
20;1;2;0;1;1;3;3
20;1;3;0;1;1;9;9
20;1;4;1;2;0;6;7
20;1;5;1;2;0;7;8
20;1;6;4;2;1;10;14
20;1;7;2;2;2;11;13
20;1;8;4;1;1;8;12
20;1;9;6;4;0;8;14
20;1;10;6;4;0;8;14
20;1;11;5;2;1;7;12
20;1;12;6;2;0;12;18
20;1;13;5;2;1;8;13
20;1;14;5;2;2;3;8
20;1;15;0;1;0;4;4
20;1;16;0;0;0;2;2
20;1;17;0;0;1;1;1
20;1;18;0;0;0;0;0
20;1;19;0;0;0;0;0
20;1;20;0;0;0;0;0
30;1;1;0;0;0;0;0
30;1;2;0;0;0;0;0
30;1;3;0;0;0;8;8
30;1;4;0;0;0;9;9
30;1;5;0;0;0;7;7
30;1;6;0;0;0;12;12
30;1;7;0;0;0;16;16
30;1;8;0;0;0;20;20
30;1;9;0;0;0;13;13
30;1;10;0;0;0;10;10
30;1;11;0;0;0;11;11
30;1;12;0;0;0;9;9
30;1;13;0;0;0;4;4
30;1;14;0;0;0;7;7
30;1;15;0;0;0;3;3
30;1;16;0;0;0;3;3
30;1;17;0;0;0;1;1
30;1;18;0;0;0;1;1
30;1;19;0;0;0;0;0
30;1;20;0;0;0;0;0
33;1;1;0;0;0;5;5
33;1;2;1;0;0;3;4
33;1;3;0;0;0;4;4
33;1;4;0;0;0;4;4
33;1;5;0;0;0;3;3
33;1;6;0;0;0;6;6
33;1;7;0;0;0;4;4
33;1;8;0;0;0;3;3
33;1;9;0;0;0;3;3
33;1;10;0;0;0;3;3
33;1;11;0;0;0;2;2
33;1;12;0;0;0;2;2
33;1;13;0;0;0;2;2
33;1;14;0;0;0;2;2
33;1;15;0;0;0;2;2
33;1;16;0;0;0;1;1
33;1;17;0;0;0;1;1
33;1;18;0;0;0;1;1
33;1;19;0;0;0;1;1
33;1;20;0;0;0;1;1
34;1;1;0;0;0;0;0
34;1;2;0;0;0;0;0
34;1;3;0;0;0;0;0
34;1;4;0;0;0;0;0
34;1;5;0;0;0;0;0
34;1;6;0;1;0;1;1
34;1;7;1;2;0;1;2
34;1;8;2;1;0;1;3
34;1;9;4;3;0;1;5
34;1;10;2;3;0;4;6
34;1;11;7;8;0;3;10
34;1;12;5;5;0;3;8
34;1;13;2;4;0;6;8
34;1;14;3;3;0;2;5
34;1;15;2;2;0;2;4
34;1;16;0;1;0;2;2
34;1;17;0;0;0;2;2
34;1;18;1;1;0;0;1
34;1;19;0;0;0;0;0
34;1;20;0;0;0;0;0
36;1;1;0;0;0;0;0
36;1;2;0;0;0;0;0
36;1;3;0;0;0;2;2
36;1;4;1;0;0;2;3
36;1;5;1;0;0;2;3
36;1;6;1;0;0;2;3
36;1;7;2;0;0;1;3
36;1;8;1;1;0;1;2
36;1;9;1;0;0;2;3
36;1;10;0;0;0;2;2
36;1;11;0;0;0;2;2
36;1;12;1;0;0;2;3
36;1;13;0;0;0;3;3
36;1;14;0;0;0;2;2
36;1;15;1;0;0;2;3
36;1;16;2;0;0;3;5
36;1;17;2;1;0;3;5
36;1;18;0;0;0;1;1
36;1;19;0;0;0;0;0
36;1;20;0;0;0;0;0
39;1;1;0;0;0;0;0
39;1;2;0;0;0;0;0
39;1;3;0;0;0;0;0
39;1;4;0;0;0;0;0
39;1;5;1;0;0;3;4
39;1;6;1;0;0;3;4
39;1;7;3;0;0;1;4
39;1;8;1;0;0;5;6
39;1;9;0;0;0;15;15
39;1;10;3;0;0;12;15
39;1;11;1;0;0;11;12
39;1;12;0;1;0;9;9
39;1;13;1;1;0;5;6
39;1;14;0;1;0;6;6
39;1;15;0;0;0;4;4
39;1;16;0;0;0;2;2
39;1;17;0;0;0;2;2
39;1;18;0;0;0;1;1
39;1;19;0;0;0;1;1
39;1;20;0;0;0;2;2
42;1;1;0;1;0;1;1
42;1;2;3;1;1;0;3
42;1;3;2;3;2;2;4
42;1;4;5;4;3;2;7
42;1;5;6;6;1;8;14
42;1;6;3;2;0;7;10
42;1;7;5;6;2;7;12
42;1;8;6;3;1;6;12
42;1;9;9;3;1;3;12
42;1;10;8;7;2;8;16
42;1;11;7;5;2;8;15
42;1;12;6;7;3;10;16
42;1;13;4;3;0;8;12
42;1;14;7;2;0;8;15
42;1;15;2;3;0;6;8
42;1;16;5;6;1;7;12
42;1;17;4;5;0;5;9
42;1;18;2;1;2;4;6
42;1;19;2;1;0;2;4
42;1;20;1;2;1;3;4
53;1;1;0;0;0;0;0
53;1;2;0;0;0;0;0
53;1;3;0;0;0;0;0
53;1;4;1;0;0;2;3
53;1;5;4;1;0;0;4
53;1;6;0;1;0;3;3
53;1;7;2;3;0;1;3
53;1;8;2;1;0;2;4
53;1;9;3;2;0;2;5
53;1;10;1;3;0;4;5
53;1;11;6;4;0;3;9
53;1;12;7;6;0;1;8
53;1;13;4;6;0;3;7
53;1;14;6;4;0;1;7
53;1;15;3;2;0;0;3
53;1;16;2;2;0;0;2
53;1;17;1;0;0;0;1
53;1;18;0;0;0;0;0
53;1;19;0;0;0;0;0
53;1;20;0;0;0;0;0
80;1;1;1;0;0;1;2
80;1;2;0;0;0;3;3
80;1;3;0;0;0;4;4
80;1;4;2;0;0;5;7
80;1;5;3;0;0;4;7
80;1;6;2;0;0;4;6
80;1;7;1;0;0;4;5
80;1;8;3;0;0;3;6
80;1;9;1;0;0;4;5
80;1;10;0;0;0;4;4
80;1;11;0;0;0;2;2
80;1;12;0;0;0;2;2
80;1;13;0;0;0;2;2
80;1;14;0;0;0;2;2
80;1;15;0;0;0;1;1
80;1;16;0;0;0;1;1
80;1;17;0;0;0;1;1
80;1;18;0;0;0;1;1
80;1;19;0;0;0;0;0
80;1;20;0;0;0;0;0
161;1;1;0;0;0;0;0
161;1;2;0;0;0;0;0
161;1;3;0;0;0;0;0
161;1;4;0;0;0;0;0
161;1;5;0;0;0;4;4
161;1;6;0;0;0;15;15
161;1;7;0;0;0;17;17
161;1;8;0;0;0;16;16
161;1;9;0;0;0;14;14
161;1;10;0;0;0;16;16
161;1;11;3;1;0;13;16
161;1;12;0;0;0;8;8
161;1;13;0;0;0;6;6
161;1;14;0;0;0;3;3
161;1;15;0;0;0;1;1
161;1;16;0;0;0;0;0
161;1;17;0;0;0;0;0
161;1;18;0;0;0;0;0
161;1;19;0;0;0;0;0
161;1;20;0;0;0;0;0
161;1;21;0;0;0;2;2
161;1;22;0;0;0;7;7
161;1;23;0;0;0;8;8
161;1;24;0;0;0;10;10
161;1;25;1;0;0;10;11
161;1;26;1;0;0;7;8
161;1;27;0;0;0;5;5
161;1;28;0;0;0;4;4
161;1;29;0;0;0;6;6
161;1;30;0;0;0;4;4
161;1;31;0;0;0;1;1
161;1;32;0;0;0;0;0
161;1;33;0;0;0;0;0
161;1;34;0;0;0;0;0
161;1;35;0;0;0;0;0
161;1;36;0;0;0;0;0
161;1;37;0;0;0;0;0
161;1;38;0;0;0;0;0
161;1;39;0;0;0;0;0
161;1;40;0;0;0;0;0
95;1;1;0;0;0;0;0
95;1;2;0;0;0;0;0
95;1;3;0;0;0;0;0
95;1;4;0;0;0;0;0
95;1;5;0;0;0;4;4
95;1;6;0;0;0;5;5
95;1;7;0;0;0;11;11
95;1;8;0;0;0;14;14
95;1;9;0;0;0;10;10
95;1;10;0;0;0;9;9
95;1;11;0;0;0;6;6
95;1;12;0;0;0;6;6
95;1;13;0;0;0;7;7
95;1;14;0;0;0;3;3
95;1;15;0;0;0;2;2
95;1;16;0;0;0;0;0
95;1;17;0;0;0;0;0
95;1;18;0;0;0;0;0
95;1;19;0;0;0;0;0
95;1;20;0;0;0;0;0
95;1;21;0;0;0;0;0
95;1;22;1;0;0;4;5
95;1;23;0;0;0;3;3
95;1;24;0;0;0;9;9
95;1;25;0;0;0;13;13
95;1;26;0;0;0;16;16
95;1;27;0;0;0;12;12
95;1;28;0;0;0;10;10
95;1;29;0;0;0;12;12
95;1;30;0;0;0;7;7
95;1;31;0;0;0;3;3
95;1;32;0;0;0;1;1
95;1;33;0;0;0;1;1
95;1;34;0;0;0;0;0
95;1;35;0;0;0;0;0
95;1;36;0;0;0;0;0
95;1;37;0;0;0;0;0
95;1;38;0;0;0;0;0
95;1;39;0;0;0;0;0
95;1;40;0;0;0;0;0
108;1;1;0;0;0;0;0
108;1;2;0;0;0;1;1
108;1;3;0;0;0;3;3
108;1;4;0;0;0;5;5
108;1;5;0;0;0;9;9
108;1;6;0;0;0;8;8
108;1;7;0;0;0;8;8
108;1;8;0;0;0;3;3
108;1;9;0;0;0;1;1
108;1;10;0;0;0;0;0
108;1;11;0;0;0;0;0
108;1;12;0;0;0;0;0
108;1;13;0;0;0;0;0
108;1;14;0;0;0;0;0
108;1;15;0;0;0;0;0
108;1;16;0;0;0;0;0
108;1;17;0;0;0;0;0
108;1;18;0;0;0;0;0
108;1;19;0;1;0;6;6
108;1;20;0;0;0;7;7
108;1;21;1;0;0;5;6
108;1;22;0;0;0;5;5
108;1;23;0;0;0;5;5
108;1;24;0;0;0;4;4
108;1;25;0;0;0;0;0
108;1;26;0;0;0;0;0
108;1;27;0;0;0;0;0
108;1;28;0;0;0;0;0
108;1;29;0;0;0;0;0
108;1;30;0;0;0;0;0
108;1;31;0;0;0;0;0
108;1;32;0;0;0;0;0
108;1;33;0;0;0;0;0
108;1;34;0;0;0;0;0
108;1;35;0;0;0;0;0
108;1;36;0;0;0;0;0
108;1;37;0;0;0;0;0
108;1;38;0;0;0;0;0
108;1;39;0;0;0;0;0
108;1;40;0;0;0;0;0
112;1;1;0;0;0;0;0
112;1;2;0;0;0;0;0
112;1;3;0;0;0;0;0
112;1;4;0;0;0;6;6
112;1;5;0;0;0;13;13
112;1;6;1;1;0;17;18
112;1;7;0;1;0;17;17
112;1;8;0;0;0;15;15
112;1;9;0;1;0;11;11
112;1;10;0;0;0;10;10
112;1;11;1;1;0;9;10
112;1;12;0;1;0;11;11
112;1;13;0;0;0;6;6
112;1;14;0;0;0;8;8
112;1;15;0;0;0;7;7
112;1;16;0;0;0;4;4
112;1;17;0;0;0;0;0
112;1;18;0;0;0;0;0
112;1;19;0;0;0;0;0
112;1;20;0;0;0;0;0
112;1;21;0;0;0;0;0
112;1;22;0;0;0;0;0
112;1;23;0;2;0;2;2
112;1;24;1;0;0;4;5
112;1;25;2;1;0;7;9
112;1;26;1;0;0;12;13
112;1;27;0;0;0;10;10
112;1;28;0;0;0;14;14
112;1;29;0;0;0;13;13
112;1;30;0;0;0;7;7
112;1;31;0;0;0;4;4
112;1;32;0;0;0;3;3
112;1;33;0;0;0;2;2
112;1;34;1;0;0;3;4
112;1;35;0;0;0;4;4
112;1;36;0;0;0;0;0
112;1;37;0;0;0;0;0
112;1;38;0;0;0;0;0
112;1;39;0;0;0;0;0
112;1;40;0;0;0;0;0
115;1;1;0;0;0;0;0
115;1;2;0;0;0;0;0
115;1;3;0;0;0;1;1
115;1;4;0;0;0;3;3
115;1;5;0;0;0;12;12
115;1;6;0;0;0;17;17
115;1;7;0;0;0;7;7
115;1;8;0;0;0;5;5
115;1;9;0;0;0;4;4
115;1;10;0;0;0;3;3
115;1;11;0;0;0;2;2
115;1;12;1;0;0;1;2
115;1;13;1;0;0;0;1
115;1;14;0;0;0;2;2
115;1;15;0;0;0;2;2
115;1;16;0;0;0;2;2
115;1;17;0;0;0;2;2
115;1;18;0;0;0;4;4
115;1;19;0;0;0;5;5
115;1;20;0;0;0;8;8
115;1;21;0;0;0;9;9
115;1;22;1;0;0;5;6
115;1;23;0;0;0;3;3
115;1;24;0;0;0;1;1
115;1;25;0;0;0;1;1
115;1;26;0;0;0;1;1
115;1;27;0;0;0;1;1
115;1;28;0;0;0;2;2
115;1;29;0;0;0;0;0
115;1;30;0;0;0;0;0
115;1;31;0;0;0;0;0
115;1;32;0;0;0;0;0
115;1;33;0;0;0;0;0
115;1;34;0;0;0;2;2
115;1;35;0;0;0;2;2
115;1;36;0;0;0;2;2
115;1;37;0;0;0;2;2
115;1;38;0;0;0;2;2
115;1;39;0;0;0;1;1
115;1;40;0;0;0;2;2
121;1;1;0;0;0;0;0
121;1;2;0;0;0;0;0
121;1;3;0;0;0;0;0
121;1;4;0;0;0;9;9
121;1;5;1;0;0;18;19
121;1;6;0;0;0;14;14
121;1;7;0;0;0;12;12
121;1;8;0;0;0;14;14
121;1;9;0;0;0;7;7
121;1;10;0;0;0;7;7
121;1;11;0;0;0;7;7
121;1;12;0;0;0;6;6
121;1;13;0;0;0;6;6
121;1;14;0;0;0;9;9
121;1;15;0;0;0;0;0
121;1;16;0;0;0;2;2
121;1;17;0;0;0;1;1
121;1;18;0;0;0;1;1
121;1;19;0;0;0;4;4
121;1;20;0;0;0;4;4
121;1;21;0;0;0;7;7
121;1;22;0;1;0;4;4
121;1;23;1;0;0;7;8
121;1;24;0;0;0;5;5
121;1;25;0;0;0;3;3
121;1;26;0;0;0;4;4
121;1;27;0;0;0;4;4
121;1;28;0;0;0;3;3
121;1;29;0;0;0;5;5
121;1;30;0;0;0;4;4
121;1;31;0;0;0;2;2
121;1;32;0;0;0;1;1
121;1;33;0;0;0;2;2
121;1;34;0;0;0;1;1
121;1;35;0;0;0;2;2
121;1;36;0;0;0;1;1
121;1;37;0;0;0;0;0
121;1;38;0;0;0;0;0
121;1;39;0;0;0;0;0
121;1;40;0;0;0;0;0
122;1;1;0;0;0;0;0
122;1;2;0;0;0;0;0
122;1;3;0;0;0;0;0
122;1;4;0;0;0;1;1
122;1;5;0;0;0;4;4
122;1;6;0;0;0;11;11
122;1;7;0;0;0;8;8
122;1;8;0;0;0;11;11
122;1;9;0;0;0;6;6
122;1;10;0;0;0;1;1
122;1;11;0;0;0;0;0
122;1;12;0;0;0;2;2
122;1;13;0;0;0;1;1
122;1;14;0;0;0;1;1
122;1;15;0;0;0;0;0
122;1;16;0;0;0;0;0
122;1;17;0;0;0;0;0
122;1;18;0;0;0;0;0
122;1;19;0;0;0;0;0
122;1;20;0;0;0;2;2
122;1;21;0;0;0;4;4
122;1;22;0;0;0;3;3
122;1;23;0;0;0;4;4
122;1;24;0;0;0;2;2
122;1;25;0;0;0;4;4
122;1;26;0;0;0;0;0
122;1;27;0;0;0;0;0
122;1;28;0;0;0;0;0
122;1;29;0;0;0;0;0
122;1;30;0;0;0;0;0
122;1;31;0;0;0;0;0
122;1;32;0;0;0;0;0
122;1;33;0;0;0;0;0
122;1;34;0;0;0;0;0
122;1;35;0;0;0;0;0
122;1;36;0;0;0;0;0
122;1;37;0;0;0;0;0
122;1;38;0;0;0;0;0
122;1;39;0;0;0;0;0
122;1;40;0;0;0;0;0
126;1;1;0;0;0;0;0
126;1;2;0;0;0;0;0
126;1;3;0;0;0;10;10
126;1;4;0;0;0;12;12
126;1;5;0;0;0;22;22
126;1;6;0;0;0;14;14
126;1;7;0;0;0;8;8
126;1;8;0;0;0;3;3
126;1;9;0;0;0;0;0
126;1;10;0;0;0;0;0
126;1;11;0;0;0;0;0
126;1;12;0;0;0;0;0
126;1;13;0;0;0;0;0
126;1;14;0;0;0;0;0
126;1;15;0;0;0;0;0
126;1;16;0;0;0;0;0
126;1;17;0;0;0;2;2
126;1;18;0;0;0;9;9
126;1;19;0;0;0;17;17
126;1;20;0;0;0;18;18
126;1;21;1;0;0;22;23
126;1;22;0;0;0;4;4
126;1;23;0;0;0;4;4
126;1;24;0;0;0;3;3
126;1;25;0;0;0;2;2
126;1;26;0;0;0;2;2
126;1;27;0;0;0;1;1
126;1;28;0;0;0;0;0
126;1;29;0;0;0;0;0
126;1;30;0;0;0;0;0
126;1;31;0;0;0;0;0
126;1;32;0;0;0;0;0
126;1;33;0;0;0;0;0
126;1;34;0;0;0;0;0
126;1;35;0;0;0;0;0
126;1;36;0;0;0;0;0
126;1;37;0;0;0;0;0
126;1;38;0;0;0;0;0
126;1;39;0;0;0;0;0
126;1;40;0;0;0;0;0
130;1;1;0;0;0;0;0
130;1;2;0;0;0;0;0
130;1;3;0;0;0;0;0
130;1;4;0;0;0;1;1
130;1;5;0;0;0;3;3
130;1;6;0;0;0;6;6
130;1;7;1;0;0;11;12
130;1;8;1;1;0;10;11
130;1;9;3;2;0;8;11
130;1;10;4;2;1;13;17
130;1;11;2;1;0;5;7
130;1;12;0;0;0;2;2
130;1;13;0;0;0;3;3
130;1;14;0;0;0;4;4
130;1;15;0;0;0;1;1
130;1;16;0;0;0;0;0
130;1;17;0;0;0;0;0
130;1;18;0;0;0;0;0
130;1;19;0;0;0;1;1
130;1;20;0;0;0;2;2
130;1;21;0;0;0;3;3
130;1;22;0;0;0;4;4
130;1;23;0;0;0;8;8
130;1;24;0;0;0;11;11
130;1;25;0;0;0;17;17
130;1;26;0;0;0;19;19
130;1;27;0;0;0;16;16
130;1;28;0;0;0;14;14
130;1;29;2;0;0;11;13
130;1;30;1;0;0;12;13
130;1;31;2;0;0;8;10
130;1;32;2;1;0;5;7
130;1;33;0;0;0;1;1
130;1;34;0;0;0;0;0
130;1;35;0;0;0;0;0
130;1;36;0;0;0;0;0
130;1;37;0;0;0;0;0
130;1;38;0;0;0;0;0
130;1;39;0;0;0;0;0
130;1;40;0;0;0;0;0
170;1;1;0;0;0;5;5
170;1;2;0;0;0;10;10
170;1;3;0;0;0;15;15
170;1;4;0;0;0;16;16
170;1;5;0;0;0;18;18
170;1;6;0;0;0;16;16
170;1;7;0;0;0;12;12
170;1;8;1;0;0;9;10
170;1;9;0;0;0;10;10
170;1;10;0;0;0;10;10
170;1;11;0;1;0;12;12
170;1;12;1;0;0;6;7
170;1;13;0;0;0;8;8
170;1;14;0;0;0;12;12
170;1;15;0;0;0;6;6
170;1;16;0;0;0;3;3
170;1;17;0;0;0;1;1
170;1;18;0;0;0;2;2
170;1;19;0;0;0;4;4
170;1;20;0;0;0;8;8
170;1;21;0;0;0;11;11
170;1;22;0;0;0;11;11
170;1;23;0;0;0;7;7
170;1;24;0;0;0;6;6
170;1;25;0;0;0;6;6
170;1;26;0;0;0;6;6
170;1;27;0;0;0;6;6
170;1;28;0;0;0;7;7
170;1;29;0;0;0;6;6
170;1;30;0;0;0;0;0
170;1;31;0;0;0;0;0
170;1;32;0;0;0;0;0
170;1;33;0;0;0;0;0
170;1;34;0;0;0;0;0
170;1;35;0;0;0;0;0
170;1;36;0;0;0;0;0
170;1;37;0;0;0;0;0
170;1;38;0;0;0;0;0
170;1;39;0;0;0;0;0
170;1;40;0;0;0;0;0
179;1;1;0;0;0;3;3
179;1;2;0;0;0;2;2
179;1;3;0;0;0;2;2
179;1;4;0;0;0;5;5
179;1;5;0;0;0;9;9
179;1;6;0;0;0;14;14
179;1;7;0;0;0;13;13
179;1;8;0;0;0;15;15
179;1;9;0;0;0;16;16
179;1;10;0;0;0;15;15
179;1;11;0;0;0;11;11
179;1;12;0;0;0;11;11
179;1;13;0;0;0;6;6
179;1;14;0;0;0;10;10
179;1;15;0;0;0;7;7
179;1;16;0;0;0;5;5
179;1;17;0;0;0;5;5
179;1;18;0;0;0;2;2
179;1;19;0;0;0;4;4
179;1;20;0;0;0;2;2
179;1;21;0;0;0;0;0
179;1;22;0;0;0;0;0
179;1;23;0;0;0;3;3
179;1;24;0;0;0;8;8
179;1;25;0;0;1;13;13
179;1;26;1;1;1;11;12
179;1;27;2;0;0;13;15
179;1;28;2;0;0;20;22
179;1;29;0;0;0;17;17
179;1;30;0;0;0;16;16
179;1;31;0;0;0;7;7
179;1;32;1;0;0;5;6
179;1;33;0;0;0;1;1
179;1;34;0;0;0;0;0
179;1;35;0;0;0;0;0
179;1;36;0;0;0;0;0
179;1;37;0;0;0;0;0
179;1;38;0;0;0;0;0
179;1;39;0;0;0;0;0
179;1;40;0;0;0;0;0
210;1;1;0;0;0;0;0
210;1;2;0;0;0;0;0
210;1;3;0;0;0;0;0
210;1;4;0;0;0;0;0
210;1;5;0;0;0;4;4
210;1;6;0;1;0;6;6
210;1;7;0;0;0;9;9
210;1;8;0;0;0;5;5
210;1;9;1;0;0;3;4
210;1;10;0;0;0;3;3
210;1;11;0;0;0;5;5
210;1;12;0;0;0;4;4
210;1;13;0;0;0;5;5
210;1;14;0;0;0;5;5
210;1;15;0;0;0;5;5
210;1;16;0;0;0;4;4
210;1;17;0;0;0;6;6
210;1;18;0;0;0;1;1
210;1;19;0;0;0;0;0
210;1;20;0;0;0;1;1
210;1;21;0;0;0;1;1
210;1;22;0;0;0;1;1
210;1;23;0;0;0;1;1
210;1;24;0;0;0;2;2
210;1;25;0;0;0;3;3
210;1;26;0;0;0;3;3
210;1;27;0;0;0;3;3
210;1;28;0;0;0;3;3
210;1;29;0;0;0;1;1
210;1;30;0;0;0;1;1
210;1;31;0;0;0;0;0
210;1;32;0;0;0;0;0
210;1;33;0;0;0;0;0
210;1;34;0;0;0;0;0
210;1;35;0;0;0;0;0
210;1;36;0;0;0;0;0
210;1;37;0;0;0;0;0
210;1;38;0;0;0;0;0
210;1;39;0;0;0;0;0
210;1;40;0;0;0;0;0
221;1;1;0;0;0;0;0
221;1;2;0;0;0;0;0
221;1;3;0;0;0;2;2
221;1;4;0;0;0;5;5
221;1;5;0;0;0;8;8
221;1;6;0;0;0;11;11
221;1;7;0;0;0;16;16
221;1;8;0;0;0;11;11
221;1;9;0;0;0;6;6
221;1;10;0;0;0;4;4
221;1;11;0;0;0;2;2
221;1;12;0;0;0;2;2
221;1;13;0;0;0;2;2
221;1;14;0;0;0;3;3
221;1;15;0;0;0;0;0
221;1;16;0;0;0;0;0
221;1;17;1;0;0;1;2
221;1;18;0;0;0;3;3
221;1;19;0;0;0;2;2
221;1;20;1;0;0;4;5
221;1;21;0;0;0;6;6
221;1;22;0;0;0;7;7
221;1;23;0;0;0;7;7
221;1;24;0;0;0;2;2
221;1;25;0;0;0;1;1
221;1;26;0;0;0;1;1
221;1;27;0;0;0;2;2
221;1;28;0;0;0;2;2
221;1;29;0;0;0;5;5
221;1;30;0;0;0;2;2
221;1;31;0;0;0;0;0
221;1;32;0;0;0;0;0
221;1;33;0;0;0;0;0
221;1;34;0;0;0;0;0
221;1;35;0;0;0;0;0
221;1;36;0;0;0;0;0
221;1;37;0;0;0;0;0
221;1;38;0;0;0;0;0
221;1;39;0;0;0;0;0
221;1;40;0;0;0;0;0
225;1;1;0;0;0;0;0
225;1;2;0;0;0;0;0
225;1;3;0;0;0;0;0
225;1;4;0;0;0;4;4
225;1;5;0;0;0;12;12
225;1;6;0;0;0;11;11
225;1;7;0;1;0;11;11
225;1;8;0;0;0;7;7
225;1;9;0;0;0;2;2
225;1;10;0;0;0;1;1
225;1;11;0;0;0;1;1
225;1;12;0;0;0;0;0
225;1;13;0;0;0;0;0
225;1;14;0;0;0;0;0
225;1;15;0;0;0;1;1
225;1;16;0;0;0;13;13
225;1;17;0;0;0;9;9
225;1;18;0;0;0;10;10
225;1;19;0;0;0;7;7
225;1;20;0;0;0;6;6
225;1;21;0;0;0;1;1
225;1;22;0;0;0;0;0
225;1;23;0;0;0;0;0
225;1;24;0;0;0;0;0
225;1;25;0;0;0;0;0
225;1;26;0;0;0;0;0
225;1;27;0;0;0;0;0
225;1;28;0;0;0;0;0
225;1;29;0;0;0;0;0
225;1;30;0;0;0;0;0
225;2;31;0;0;0;1;1
225;2;32;0;0;0;4;4
225;2;33;0;0;0;6;6
225;2;34;0;0;0;11;11
225;2;35;0;0;0;4;4
225;2;36;0;0;0;5;5
225;2;37;0;0;0;3;3
225;2;38;0;0;0;8;8
225;2;39;0;0;0;0;0
225;2;40;0;0;0;0;0
178;1;1;0;0;0;0;0
178;1;2;0;0;0;0;0
178;1;3;0;0;0;8;8
178;1;4;0;0;0;26;26
178;1;5;0;0;0;20;20
178;1;6;0;0;0;18;18
178;1;7;0;0;0;19;19
178;1;8;0;0;0;19;19
178;1;9;0;0;0;13;13
178;1;10;0;0;0;9;9
178;1;11;0;0;0;7;7
178;1;12;0;0;0;8;8
178;1;13;0;0;0;10;10
178;1;14;0;0;0;13;13
178;1;15;0;0;0;26;26
178;1;16;0;0;0;1;1
178;1;17;0;0;0;1;1
178;1;18;0;0;0;6;6
178;1;19;0;0;0;5;5
178;1;20;0;0;0;4;4
178;1;21;0;0;0;7;7
178;1;22;0;0;0;15;15
178;1;23;0;0;0;20;20
178;1;24;0;0;0;24;24
178;1;25;0;0;0;23;23
178;1;26;0;0;0;15;15
178;1;27;0;0;0;13;13
178;1;28;0;0;0;12;12
178;1;29;0;0;0;10;10
178;1;30;0;0;0;1;1
178;2;31;0;0;0;0;0
178;2;32;0;0;0;3;3
178;2;33;0;0;0;17;17
178;2;34;1;0;0;16;17
178;2;35;0;0;0;14;14
178;2;36;0;0;0;9;9
178;2;37;0;0;0;9;9
178;2;38;0;0;0;16;16
178;2;39;0;0;0;6;6
178;2;40;0;0;0;5;5
141;1;1;0;0;0;0;0
141;1;2;0;0;0;3;3
141;1;3;0;0;0;11;11
141;1;4;0;0;0;15;15
141;1;5;0;0;0;16;16
141;1;6;0;0;0;13;13
141;1;7;1;0;0;10;11
141;1;8;0;0;0;14;14
141;1;9;0;0;0;8;8
141;1;10;0;0;0;11;11
141;1;11;0;0;0;6;6
141;1;12;1;0;0;3;4
141;1;13;0;0;0;3;3
141;1;14;0;0;0;0;0
141;1;15;0;0;0;0;0
141;1;16;0;0;0;0;0
141;1;17;0;0;0;0;0
141;1;18;0;0;0;0;0
141;1;19;0;0;0;0;0
141;1;20;0;0;0;0;0
189;1;1;0;0;0;1;1
189;1;2;0;0;0;1;1
189;1;3;0;0;0;4;4
189;1;4;0;0;0;11;11
189;1;5;0;0;0;14;14
189;1;6;0;0;0;11;11
189;1;7;0;0;0;14;14
189;1;8;0;0;0;13;13
189;1;9;0;0;0;12;12
189;1;10;0;0;0;8;8
189;1;11;0;0;0;8;8
189;1;12;0;0;0;8;8
189;1;13;0;0;0;5;5
189;1;14;0;0;0;5;5
189;1;15;0;0;0;6;6
189;1;16;0;0;0;3;3
189;1;17;0;0;0;3;3
189;1;18;0;0;0;3;3
189;1;19;0;0;0;3;3
189;1;20;0;0;0;4;4
228;1;1;0;0;0;2;2
228;1;2;0;0;0;2;2
228;1;3;0;0;0;5;5
228;1;4;0;0;0;7;7
228;1;5;0;0;0;11;11
228;1;6;0;0;0;9;9
228;1;7;0;0;0;13;13
228;1;8;0;0;0;12;12
228;1;9;0;0;0;9;9
228;1;10;0;0;0;9;9
228;1;11;0;0;0;3;3
228;1;12;0;0;0;1;1
228;1;13;0;0;0;0;0
228;1;14;0;0;0;0;0
228;1;15;0;0;0;0;0
228;1;16;0;0;0;0;0
228;1;17;0;0;0;0;0
228;1;18;0;0;0;0;0
228;1;19;0;0;0;0;0
228;1;20;0;0;0;0;0
142;1;1;0;0;0;0;0
142;1;2;0;0;0;0;0
142;1;3;0;3;0;3;3
142;1;4;4;5;0;3;7
142;1;5;13;14;0;8;21
142;1;6;18;11;0;7;25
142;1;7;8;7;0;4;12
142;1;8;3;5;0;3;6
142;1;9;1;2;0;3;4
142;1;10;0;1;0;1;1
142;1;11;0;0;0;0;0
142;1;12;0;0;0;0;0
142;1;13;0;0;0;0;0
142;1;14;0;0;0;0;0
142;1;15;0;0;0;0;0
142;1;16;0;0;0;0;0
142;1;17;0;0;0;0;0
142;1;18;0;1;0;1;1
142;1;19;10;17;0;15;25
142;1;20;11;14;0;16;27
142;1;21;10;10;0;10;20
142;1;22;8;7;0;6;14
142;1;23;6;6;0;6;12
142;1;24;4;4;0;4;8
142;1;25;5;2;0;5;10
142;1;26;3;3;0;0;3
142;1;27;2;2;0;0;2
142;1;28;1;1;0;0;1
142;1;29;3;3;0;1;4
142;1;30;2;2;0;2;4
142;1;31;0;1;0;1;1
142;1;32;0;1;0;1;1
142;1;33;1;1;0;0;1
142;1;34;0;0;0;0;0
142;1;35;0;0;0;0;0
142;1;36;0;0;0;0;0
142;1;37;0;0;0;0;0
142;1;38;0;0;0;0;0
142;1;39;0;0;0;0;0
142;1;40;0;0;0;0;0
173;1;1;0;0;0;1;1
173;1;2;0;0;0;2;2
173;1;3;0;0;0;16;16
173;1;4;0;0;0;14;14
173;1;5;0;0;0;14;14
173;1;6;0;0;0;14;14
173;1;7;0;0;0;19;19
173;1;8;0;0;0;19;19
173;1;9;0;0;0;16;16
173;1;10;0;0;0;20;20
173;1;11;1;0;0;26;27
173;1;12;0;0;0;11;11
173;1;13;0;0;0;11;11
173;1;14;0;0;0;16;16
173;1;15;0;0;0;12;12
173;1;16;0;0;0;1;1
173;1;17;0;0;0;2;2
173;1;18;0;0;0;4;4
173;1;19;0;0;0;3;3
173;1;20;0;0;0;3;3
173;1;21;0;0;0;7;7
173;1;22;0;0;0;8;8
173;1;23;0;0;0;8;8
173;1;24;1;0;0;7;8
173;1;25;1;0;0;12;13
173;1;26;2;0;0;11;13
173;1;27;2;0;0;9;11
173;1;28;2;0;0;9;11
173;1;29;1;0;0;10;11
173;1;30;2;0;0;7;9
173;1;31;0;0;0;6;6
173;1;32;0;0;0;5;5
173;1;33;0;0;0;5;5
173;1;34;0;0;0;3;3
173;1;35;0;0;0;2;2
173;1;36;0;0;0;1;1
173;1;37;0;0;0;1;1
173;1;38;0;0;0;2;2
173;1;39;0;0;0;3;3
173;1;40;0;0;0;2;2
184;1;1;0;0;0;0;0
184;1;2;2;0;1;1;3
184;1;3;3;1;0;3;6
184;1;4;2;0;0;8;10
184;1;5;2;0;0;11;13
184;1;6;6;0;0;8;14
184;1;7;5;0;0;4;9
184;1;8;3;0;0;3;6
184;1;9;1;0;0;1;2
184;1;10;1;0;0;1;2
184;1;11;4;0;1;0;4
184;1;12;0;0;0;0;0
184;1;13;0;0;0;0;0
184;1;14;0;0;0;0;0
184;1;15;0;0;0;0;0
184;1;16;0;0;0;0;0
184;1;17;0;0;0;0;0
184;1;18;2;0;0;2;4
184;1;19;1;0;0;4;5
184;1;20;1;0;0;4;5
184;1;21;4;0;1;1;5
184;1;22;5;1;0;6;11
184;1;23;5;0;0;6;11
184;1;24;3;0;0;4;7
184;1;25;2;0;0;5;7
184;1;26;1;0;0;3;4
184;1;27;0;0;0;3;3
184;1;28;0;0;0;0;0
184;1;29;0;0;0;0;0
184;1;30;0;0;0;0;0
184;1;31;0;0;0;0;0
184;1;32;0;0;0;0;0
184;1;33;0;0;0;0;0
184;1;34;0;0;0;0;0
184;1;35;0;0;0;0;0
184;1;36;0;0;0;0;0
184;1;37;0;0;0;0;0
184;1;38;0;0;0;0;0
184;1;39;0;0;0;0;0
184;1;40;0;0;0;0;0
104;1;1;0;0;0;0;0
104;1;2;0;0;0;0;0
104;1;3;6;2;0;3;9
104;1;4;4;4;0;3;7
104;1;5;2;1;0;1;3
104;1;6;0;0;0;1;1
104;1;7;0;0;0;0;0
104;1;8;0;0;0;0;0
104;1;9;0;0;0;0;0
104;1;10;2;1;0;0;2
104;1;11;8;5;0;1;9
104;1;12;7;6;0;2;9
104;1;13;7;6;0;2;9
104;1;14;3;2;0;1;4
104;1;15;2;2;0;0;2
104;1;16;0;0;0;0;0
104;1;17;0;0;0;0;0
104;1;18;0;0;0;0;0
104;1;19;0;0;0;0;0
104;1;20;0;0;0;0;0
104;2;21;0;0;0;0;0
104;2;22;1;1;0;0;1
104;2;23;3;2;0;0;3
104;2;24;10;4;0;1;11
104;2;25;8;2;0;1;9
104;2;26;2;1;0;1;3
104;2;27;3;1;0;0;3
104;2;28;2;1;0;0;2
104;2;29;2;1;0;0;2
104;2;30;0;0;0;0;0
104;2;31;0;0;0;0;0
104;2;32;3;3;0;0;3
104;2;33;0;0;0;0;0
104;2;34;0;0;0;0;0
104;2;35;0;0;0;0;0
104;2;36;0;0;0;0;0
104;2;37;0;0;0;0;0
104;2;38;0;0;0;0;0
104;2;39;0;0;0;0;0
104;2;40;0;0;0;0;0
105;1;1;0;0;0;1;1
105;1;2;1;2;0;8;9
105;1;3;4;0;0;5;9
105;1;4;1;0;0;6;7
105;1;5;1;0;0;3;4
105;1;6;0;0;0;2;2
105;1;7;0;0;0;0;0
105;1;8;0;0;0;0;0
105;1;9;3;1;0;1;4
105;1;10;3;1;0;2;5
105;1;11;5;3;0;6;11
105;1;12;1;1;0;4;5
105;1;13;1;1;0;1;2
105;1;14;0;0;0;0;0
105;1;15;0;0;0;0;0
105;1;16;0;0;0;0;0
105;1;17;0;0;0;0;0
105;1;18;0;0;0;0;0
105;1;19;0;0;0;0;0
105;1;20;0;0;0;0;0
105;2;21;0;0;0;0;0
105;2;22;3;1;0;4;7
105;2;23;5;3;0;8;13
105;2;24;3;0;0;11;14
105;2;25;3;0;0;10;13
105;2;26;1;1;0;6;7
105;2;27;2;2;0;3;5
105;2;28;1;1;0;3;4
105;2;29;0;0;0;0;0
105;2;30;0;0;0;0;0
105;2;31;0;0;0;0;0
105;2;32;1;0;0;2;3
105;2;33;1;0;0;2;3
105;2;34;0;0;0;2;2
105;2;35;1;2;0;1;2
105;2;36;0;0;0;0;0
105;2;37;0;0;0;0;0
105;2;38;0;0;0;0;0
105;2;39;0;0;0;0;0
105;2;40;0;0;0;0;0
113;1;1;0;0;0;0;0
113;1;2;0;0;0;0;0
113;1;3;1;0;0;6;7
113;1;4;0;0;0;6;6
113;1;5;0;0;0;6;6
113;1;6;0;0;0;4;4
113;1;7;0;0;0;3;3
113;1;8;0;0;0;4;4
113;1;9;0;0;0;3;3
113;1;10;0;0;0;0;0
113;1;11;0;0;0;1;1
113;1;12;0;0;0;4;4
113;1;13;0;0;0;6;6
113;1;14;0;0;0;9;9
113;1;15;1;0;0;8;9
113;1;16;1;0;0;9;10
113;1;17;0;0;0;3;3
113;1;18;0;0;0;0;0
113;1;19;0;0;0;0;0
113;1;20;0;0;0;0;0
113;2;21;0;0;0;0;0
113;2;22;0;0;0;2;2
113;2;23;0;0;0;8;8
113;2;24;0;0;0;9;9
113;2;25;0;0;0;9;9
113;2;26;0;0;0;10;10
113;2;27;0;0;0;5;5
113;2;28;0;0;0;4;4
113;2;29;0;0;0;7;7
113;2;30;0;0;0;6;6
113;2;31;0;0;0;3;3
113;2;32;0;0;0;1;1
113;2;33;0;0;0;0;0
113;2;34;0;0;0;1;1
113;2;35;0;0;0;3;3
113;2;36;0;0;0;1;1
113;2;37;0;0;0;1;1
113;2;38;0;0;0;0;0
113;2;39;0;0;0;0;0
113;2;40;0;0;0;0;0
116;1;1;0;0;0;0;0
116;1;2;1;0;0;0;1
116;1;3;0;0;0;6;6
116;1;4;1;0;0;10;11
116;1;5;2;0;0;7;9
116;1;6;1;2;0;7;8
116;1;7;0;0;0;3;3
116;1;8;0;0;0;2;2
116;1;9;0;0;0;0;0
116;1;10;0;0;0;0;0
116;1;11;0;0;0;0;0
116;1;12;0;0;0;0;0
116;1;13;0;0;0;1;1
116;1;14;2;1;0;4;6
116;1;15;4;1;0;4;8
116;1;16;3;1;0;3;6
116;1;17;2;0;0;3;5
116;1;18;3;1;0;0;3
116;1;19;0;0;0;0;0
116;1;20;0;0;0;0;0
116;2;21;0;0;0;0;0
116;2;22;0;0;0;1;1
116;2;23;2;1;0;5;7
116;2;24;1;0;0;10;11
116;2;25;2;0;0;14;16
116;2;26;1;0;0;21;22
116;2;27;3;0;0;8;11
116;2;28;1;0;0;8;9
116;2;29;1;0;0;8;9
116;2;30;1;0;0;8;9
116;2;31;0;0;0;3;3
116;2;32;0;0;0;1;1
116;2;33;2;0;0;2;4
116;2;34;0;0;0;4;4
116;2;35;1;0;0;3;4
116;2;36;1;0;0;4;5
116;2;37;0;0;0;4;4
116;2;38;0;0;0;2;2
116;2;39;1;0;0;5;6
116;2;40;0;0;0;0;0
124;1;1;0;0;0;0;0
124;1;2;1;1;0;0;1
124;1;3;7;4;0;1;8
124;1;4;5;4;0;3;8
124;1;5;6;3;0;1;7
124;1;6;4;2;0;0;4
124;1;7;0;0;0;0;0
124;1;8;0;0;0;0;0
124;1;9;0;0;0;0;0
124;1;10;0;0;0;0;0
124;1;11;4;4;0;2;6
124;1;12;8;2;0;4;12
124;1;13;8;5;0;3;11
124;1;14;7;1;0;1;8
124;1;15;3;2;0;1;4
124;1;16;0;0;0;0;0
124;1;17;0;0;0;0;0
124;1;18;0;0;0;0;0
124;1;19;0;0;0;0;0
124;1;20;0;0;0;0;0
124;2;21;0;0;0;0;0
124;2;22;0;0;0;0;0
124;2;23;2;2;0;0;2
124;2;24;10;5;0;0;10
124;2;25;8;4;0;2;10
124;2;26;8;5;0;0;8
124;2;27;3;3;0;0;3
124;2;28;2;2;0;0;2
124;2;29;0;0;0;0;0
124;2;30;0;0;0;0;0
124;2;31;0;0;0;0;0
124;2;32;1;0;0;0;1
124;2;33;6;1;0;1;7
124;2;34;2;3;0;4;6
124;2;35;5;3;0;0;5
124;2;36;4;2;0;0;4
124;2;37;1;0;0;0;1
124;2;38;0;0;0;0;0
124;2;39;0;0;0;0;0
124;2;40;0;0;0;0;0
134;1;1;0;0;0;0;0
134;1;2;0;0;0;5;5
134;1;3;1;1;0;9;10
134;1;4;0;0;0;9;9
134;1;5;0;0;0;13;13
134;1;6;0;0;0;5;5
134;1;7;0;0;0;3;3
134;1;8;0;0;0;2;2
134;1;9;0;0;0;0;0
134;1;10;0;0;0;3;3
134;1;11;1;0;0;7;8
134;1;12;0;0;0;12;12
134;1;13;0;0;0;5;5
134;1;14;0;0;0;6;6
134;1;15;0;0;0;3;3
134;1;16;0;0;0;2;2
134;1;17;0;0;0;1;1
134;1;18;0;0;0;0;0
134;1;19;0;0;0;0;0
134;1;20;0;0;0;0;0
134;2;21;0;0;0;0;0
134;2;22;0;0;0;0;0
134;2;23;0;0;0;1;1
134;2;24;0;0;0;5;5
134;2;25;0;0;0;8;8
134;2;26;1;1;0;4;5
134;2;27;0;0;0;0;0
134;2;28;0;0;0;0;0
134;2;29;0;0;0;1;1
134;2;30;0;0;0;7;7
134;2;31;0;0;0;13;13
134;2;32;0;0;0;6;6
134;2;33;0;0;0;3;3
134;2;34;0;0;0;0;0
134;2;35;0;0;0;0;0
134;2;36;0;0;0;0;0
134;2;37;0;0;0;0;0
134;2;38;0;0;0;0;0
134;2;39;0;0;0;0;0
134;2;40;0;0;0;0;0
136;1;1;0;0;0;0;0
136;1;2;0;0;0;1;1
136;1;3;0;0;0;6;6
136;1;4;2;0;0;24;26
136;1;5;0;0;0;22;22
136;1;6;0;0;0;9;9
136;1;7;0;0;0;4;4
136;1;8;0;0;0;4;4
136;1;9;0;0;0;0;0
136;1;10;0;0;0;0;0
136;1;11;0;0;0;1;1
136;1;12;0;0;0;6;6
136;1;13;0;0;0;14;14
136;1;14;0;0;0;17;17
136;1;15;0;0;0;13;13
136;1;16;0;0;0;10;10
136;1;17;0;0;0;5;5
136;1;18;0;0;0;0;0
136;1;19;0;0;0;0;0
136;1;20;0;0;0;0;0
136;2;21;0;0;0;0;0
136;2;22;0;0;0;1;1
136;2;23;0;0;0;10;10
136;2;24;0;0;0;28;28
136;2;25;0;0;0;19;19
136;2;26;0;0;0;21;21
136;2;27;1;0;0;22;23
136;2;28;0;0;0;16;16
136;2;29;0;0;0;14;14
136;2;30;0;0;0;9;9
136;2;31;0;0;0;13;13
136;2;32;0;0;0;8;8
136;2;33;0;0;0;5;5
136;2;34;0;0;0;3;3
136;2;35;0;0;0;3;3
136;2;36;0;0;0;4;4
136;2;37;0;0;0;4;4
136;2;38;0;0;0;2;2
136;2;39;0;0;0;0;0
136;2;40;0;0;0;0;0
171;1;1;0;0;0;0;0
171;1;2;0;0;0;8;8
171;1;3;0;0;0;10;10
171;1;4;0;0;0;8;8
171;1;5;0;0;0;14;14
171;1;6;0;0;0;8;8
171;1;7;0;0;0;12;12
171;1;8;0;0;0;10;10
171;1;9;0;0;0;3;3
171;1;10;0;0;0;1;1
171;1;11;0;0;0;0;0
171;1;12;0;0;0;6;6
171;1;13;0;0;0;4;4
171;1;14;0;0;0;8;8
171;1;15;0;0;0;8;8
171;1;16;0;0;0;2;2
171;1;17;0;0;0;2;2
171;1;18;0;0;0;0;0
171;1;19;0;0;0;0;0
171;1;20;0;0;0;0;0
171;2;21;0;0;0;2;2
171;2;22;0;0;0;5;5
171;2;23;0;0;0;11;11
171;2;24;0;0;0;14;14
171;2;25;0;0;0;12;12
171;2;26;0;0;0;10;10
171;2;27;0;0;0;7;7
171;2;28;0;0;0;3;3
171;2;29;0;0;0;8;8
171;2;30;0;0;0;6;6
171;2;31;0;0;0;0;0
171;2;32;0;0;0;0;0
171;2;33;0;0;0;1;1
171;2;34;0;0;0;1;1
171;2;35;0;0;0;4;4
171;2;36;0;0;0;1;1
171;2;37;0;0;0;0;0
171;2;38;0;0;0;0;0
171;2;39;0;0;0;0;0
171;2;40;0;0;0;0;0
182;1;1;0;0;0;0;0
182;1;2;2;0;0;1;3
182;1;3;9;1;0;4;13
182;1;4;8;2;0;3;11
182;1;5;5;0;0;6;11
182;1;6;8;1;0;4;12
182;1;7;7;1;0;4;11
182;1;8;4;0;0;4;8
182;1;9;0;0;0;2;2
182;1;10;0;0;0;0;0
182;1;11;0;0;0;1;1
182;1;12;0;0;0;3;3
182;1;13;6;0;0;1;7
182;1;14;6;3;0;0;6
182;1;15;5;1;0;3;8
182;1;16;5;2;0;1;6
182;1;17;2;0;0;2;4
182;1;18;5;0;0;3;8
182;1;19;2;1;0;1;3
182;1;20;0;0;0;0;0
182;2;21;0;0;0;0;0
182;2;22;5;1;0;3;8
182;2;23;7;2;0;3;10
182;2;24;5;1;0;2;7
182;2;25;7;1;0;1;8
182;2;26;8;1;0;0;8
182;2;27;3;0;0;0;3
182;2;28;2;0;0;0;2
182;2;29;1;0;0;1;2
182;2;30;0;0;0;0;0
182;2;31;0;0;0;0;0
182;2;32;4;0;0;0;4
182;2;33;4;1;0;1;5
182;2;34;1;0;0;0;1
182;2;35;0;0;0;0;0
182;2;36;0;0;0;0;0
182;2;37;0;0;0;0;0
182;2;38;0;0;0;0;0
182;2;39;0;0;0;0;0
182;2;40;0;0;0;0;0
193;1;1;0;0;0;0;0
193;1;2;1;0;0;6;7
193;1;3;2;2;0;5;7
193;1;4;2;0;0;6;8
193;1;5;0;0;0;4;4
193;1;6;1;1;0;2;3
193;1;7;2;1;0;1;3
193;1;8;0;0;0;1;1
193;1;9;1;0;0;2;3
193;1;10;2;1;0;2;4
193;1;11;2;0;0;3;5
193;1;12;4;0;0;2;6
193;1;13;2;2;0;2;4
193;1;14;1;1;0;2;3
193;1;15;0;0;0;1;1
193;1;16;0;0;0;0;0
193;1;17;0;0;0;0;0
193;1;18;0;0;0;0;0
193;1;19;0;0;0;0;0
193;1;20;0;0;0;0;0
193;2;21;0;0;0;0;0
193;2;22;2;0;0;6;8
193;2;23;5;0;0;4;9
193;2;24;2;0;0;6;8
193;2;25;3;0;0;3;6
193;2;26;1;3;0;3;4
193;2;27;1;1;0;2;3
193;2;28;2;0;0;2;4
193;2;29;1;1;0;2;3
193;2;30;0;0;0;1;1
193;2;31;1;1;0;0;1
193;2;32;3;0;0;1;4
193;2;33;4;3;0;3;7
193;2;34;6;2;0;1;7
193;2;35;3;2;0;0;3
193;2;36;1;2;0;1;2
193;2;37;1;2;0;1;2
193;2;38;1;1;0;0;1
193;2;39;0;0;0;0;0
193;2;40;0;0;0;0;0
222;1;1;0;0;0;0;0
222;1;2;0;0;0;12;12
222;1;3;0;0;0;12;12
222;1;4;0;0;0;7;7
222;1;5;0;0;0;5;5
222;1;6;0;0;0;5;5
222;1;7;0;0;0;7;7
222;1;8;0;0;0;7;7
222;1;9;0;0;0;4;4
222;1;10;0;0;0;5;5
222;2;11;0;0;0;0;0
222;2;12;0;0;0;7;7
222;2;13;0;0;0;8;8
222;2;14;0;1;0;6;6
222;2;15;0;0;0;4;4
222;2;16;0;0;0;0;0
222;2;17;0;0;0;2;2
222;2;18;0;0;0;2;2
222;2;19;0;0;0;0;0
222;2;20;0;0;0;0;0
224;1;1;0;0;0;0;0
224;1;2;2;2;0;6;8
224;1;3;2;1;0;6;8
224;1;4;2;2;0;3;5
224;1;5;0;0;0;0;0
224;1;6;0;0;0;3;3
224;1;7;1;1;0;6;7
224;1;8;2;1;0;3;5
224;1;9;0;1;0;4;4
224;1;10;0;0;0;0;0
224;2;11;0;1;0;1;1
224;2;12;2;2;0;2;4
224;2;13;1;5;0;6;7
224;2;14;0;1;0;2;2
224;2;15;1;1;0;1;2
224;2;16;1;3;0;2;3
224;2;17;9;9;0;13;22
224;2;18;3;3;0;10;13
224;2;19;0;0;0;1;1
224;2;20;0;0;0;1;1
87;1;1;1;1;0;0;1
87;1;2;8;8;0;6;14
87;1;3;4;5;0;6;10
87;1;4;4;5;0;4;8
87;1;5;1;1;0;2;3
87;1;6;1;1;0;1;2
87;1;7;0;0;0;2;2
87;1;8;13;5;0;4;17
87;1;9;11;1;0;4;15
87;1;10;10;1;0;4;14
87;1;11;4;0;0;2;6
87;1;12;1;1;0;0;1
87;1;13;0;0;0;0;0
87;1;14;0;0;0;0;0
87;2;15;1;1;0;0;1
87;2;16;6;2;0;1;7
87;2;17;5;2;0;2;7
87;2;18;2;1;0;1;3
87;2;19;2;2;0;2;4
87;2;20;1;1;0;1;2
93;1;1;0;0;0;0;0
93;1;2;0;0;0;7;7
93;1;3;0;0;0;20;20
93;1;4;0;0;0;12;12
93;1;5;0;0;0;4;4
93;1;6;0;0;0;0;0
93;1;7;0;0;0;0;0
93;1;8;0;0;0;0;0
93;1;9;0;0;0;3;3
93;1;10;0;0;0;12;12
93;1;11;0;0;0;9;9
93;1;12;0;0;0;4;4
93;1;13;0;0;0;4;4
93;1;14;0;0;0;0;0
93;2;15;0;0;0;0;0
93;2;16;0;0;0;7;7
93;2;17;0;0;0;12;12
93;2;18;0;0;0;10;10
93;2;19;0;0;0;4;4
93;2;20;0;0;0;1;1
137;1;1;0;0;0;0;0
137;1;2;2;3;0;1;3
137;1;3;8;3;0;12;20
137;1;4;1;0;0;7;8
137;1;5;0;0;0;2;2
137;1;6;0;0;0;1;1
137;1;7;0;0;0;1;1
137;1;8;2;1;0;1;3
137;1;9;2;2;0;4;6
137;1;10;0;0;0;2;2
137;1;11;0;1;0;2;2
137;1;12;0;0;0;0;0
137;1;13;0;0;0;0;0
137;1;14;0;0;0;0;0
137;2;15;0;0;0;0;0
137;2;16;3;1;0;6;9
137;2;17;3;0;0;6;9
137;2;18;3;3;0;5;8
137;2;19;0;0;0;0;0
137;2;20;0;0;0;0;0
174;1;1;0;0;0;0;0
174;1;2;0;0;0;0;0
174;1;3;1;0;0;6;7
174;1;4;1;0;0;7;8
174;1;5;1;0;0;5;6
174;1;6;1;1;0;0;1
174;1;7;1;0;0;0;1
174;1;8;0;0;0;4;4
174;1;9;1;0;0;4;5
174;1;10;2;0;0;5;7
174;1;11;1;1;0;9;10
174;1;12;0;0;0;3;3
174;1;13;0;0;0;0;0
174;1;14;0;0;0;0;0
174;2;15;0;0;0;0;0
174;2;16;0;0;0;5;5
174;2;17;1;0;0;8;9
174;2;18;0;0;0;9;9
174;2;19;0;0;0;7;7
174;2;20;0;1;0;9;9
175;1;1;0;0;0;0;0
175;1;2;2;2;0;5;7
175;1;3;3;0;0;3;6
175;1;4;5;1;0;2;7
175;1;5;2;1;0;4;6
175;1;6;2;0;0;1;3
175;1;7;0;0;0;1;1
175;1;8;0;0;0;0;0
175;1;9;1;1;0;6;7
175;1;10;5;2;0;4;9
175;1;11;5;4;0;4;9
175;1;12;2;0;0;1;3
175;1;13;0;0;0;0;0
175;1;14;0;0;0;0;0
175;2;15;0;0;0;0;0
175;2;16;5;2;0;6;11
175;2;17;5;2;0;6;11
175;2;18;5;1;0;6;11
175;2;19;2;0;0;2;4
175;2;20;0;0;0;2;2
219;1;1;0;0;0;1;1
219;1;2;0;0;0;10;10
219;1;3;0;0;0;13;13
219;1;4;0;0;0;17;17
219;1;5;0;0;0;10;10
219;1;6;0;0;0;7;7
219;1;7;0;0;0;4;4
219;1;8;0;0;0;7;7
219;1;9;0;0;0;8;8
219;1;10;0;0;0;5;5
219;1;11;0;0;0;6;6
219;1;12;0;0;0;0;0
219;1;13;0;0;0;0;0
219;1;14;0;0;0;0;0
219;2;15;0;0;0;1;1
219;2;16;0;0;0;10;10
219;2;17;0;0;0;11;11
219;2;18;0;0;0;12;12
219;2;19;0;0;0;5;5
219;2;20;0;0;0;2;2
226;1;1;0;0;0;0;0
226;1;2;3;0;0;8;11
226;1;3;2;0;0;7;9
226;1;4;0;0;0;5;5
226;1;5;0;0;0;1;1
226;1;6;0;0;0;0;0
226;1;7;0;0;0;0;0
226;1;8;0;0;0;7;7
226;1;9;0;0;0;14;14
226;1;10;1;0;0;5;6
226;1;11;1;1;0;6;7
226;1;12;0;0;0;1;1
226;1;13;0;0;0;1;1
226;1;14;0;0;0;0;0
226;2;15;0;0;0;0;0
226;2;16;0;0;0;0;0
226;2;17;1;0;0;4;5
226;2;18;0;0;0;1;1
226;2;19;0;0;0;0;0
226;2;20;0;0;0;0;0
234;1;1;0;0;0;0;0
234;1;2;0;0;0;11;11
234;1;3;0;0;0;14;14
234;1;4;0;0;0;15;15
234;1;5;0;0;0;4;4
234;1;6;0;0;0;2;2
234;1;7;0;0;0;0;0
234;1;8;0;0;0;4;4
234;1;9;0;0;0;13;13
234;1;10;0;0;0;8;8
234;1;11;0;0;0;4;4
234;1;12;0;0;0;0;0
234;1;13;0;0;0;0;0
234;1;14;0;0;0;0;0
234;2;15;0;0;0;3;3
234;2;16;0;0;0;9;9
234;2;17;0;0;0;8;8
234;2;18;0;0;0;6;6
234;2;19;0;0;0;6;6
234;2;20;0;0;0;0;0
241;1;1;0;0;0;0;0
241;1;2;0;0;0;3;3
241;1;3;2;1;1;8;10
241;1;4;1;0;0;6;7
241;1;5;1;0;0;2;3
241;1;6;0;0;0;0;0
241;1;7;0;0;0;0;0
241;1;8;4;0;0;3;7
241;1;9;4;0;0;7;11
241;1;10;2;1;0;5;7
241;1;11;0;0;0;3;3
241;1;12;0;0;0;0;0
241;1;13;0;0;0;0;0
241;1;14;0;0;0;0;0
241;2;15;0;0;0;0;0
241;2;16;1;1;0;1;2
241;2;17;2;2;0;8;10
241;2;18;1;0;0;7;8
241;2;19;0;0;0;3;3
241;2;20;1;0;0;4;5
82;1;1;0;0;0;0;0
82;1;2;0;0;0;4;4
82;1;3;0;0;0;7;7
82;1;4;0;0;0;10;10
82;1;5;0;0;0;4;4
82;1;6;0;0;0;3;3
82;1;7;0;0;0;1;1
82;1;8;0;0;0;4;4
82;1;9;0;0;0;0;0
82;1;10;0;0;0;8;8
82;1;11;0;0;0;3;3
82;1;12;0;0;0;2;2
82;1;13;0;0;0;6;6
82;1;14;0;0;0;7;7
82;1;15;0;0;0;1;1
82;1;16;0;0;0;0;0
82;1;17;0;0;0;0;0
82;1;18;0;0;0;0;0
82;1;19;0;0;0;0;0
82;1;20;0;0;0;0;0
83;1;1;0;0;0;0;0
83;1;2;0;0;0;0;0
83;1;3;2;1;0;0;2
83;1;4;10;4;0;3;13
83;1;5;7;1;0;3;10
83;1;6;8;3;0;2;10
83;1;7;5;2;0;0;5
83;1;8;3;1;0;0;3
83;1;9;1;0;0;0;1
83;1;10;1;1;0;0;1
83;1;11;5;1;0;0;5
83;1;12;4;0;0;0;4
83;1;13;10;6;0;2;12
83;1;14;6;3;0;3;9
83;1;15;8;3;0;2;10
83;1;16;5;2;0;2;7
83;1;17;1;1;0;0;1
83;1;18;1;1;0;0;1
83;1;19;1;1;0;0;1
83;1;20;0;0;0;0;0
84;1;1;0;0;0;0;0
84;1;2;0;0;0;0;0
84;1;3;0;0;0;0;0
84;1;4;0;0;0;23;23
84;1;5;0;0;0;15;15
84;1;6;2;0;0;17;19
84;1;7;0;0;0;8;8
84;1;8;0;0;0;7;7
84;1;9;0;0;0;4;4
84;1;10;0;0;0;6;6
84;1;11;0;0;0;1;1
84;1;12;0;0;0;0;0
84;1;13;0;0;0;0;0
84;1;14;0;0;0;2;2
84;1;15;1;0;0;21;22
84;1;16;0;0;0;24;24
84;1;17;0;0;0;19;19
84;1;18;0;0;0;2;2
84;1;19;0;0;0;9;9
84;1;20;0;0;0;0;0
85;1;1;0;0;0;0;0
85;1;2;0;0;0;3;3
85;1;3;0;1;0;10;10
85;1;4;1;0;0;8;9
85;1;5;0;0;0;3;3
85;1;6;0;0;0;2;2
85;1;7;0;0;0;3;3
85;1;8;0;0;0;3;3
85;1;9;0;0;0;0;0
85;1;10;0;0;0;1;1
85;1;11;0;0;0;3;3
85;1;12;0;0;0;4;4
85;1;13;0;0;0;14;14
85;1;14;1;0;0;9;10
85;1;15;0;0;0;5;5
85;1;16;0;0;0;3;3
85;1;17;0;0;0;5;5
85;1;18;0;0;0;0;0
85;1;19;0;0;0;3;3
85;1;20;0;0;0;0;0
86;1;1;0;0;0;0;0
86;1;2;4;0;0;1;5
86;1;3;7;0;2;6;13
86;1;4;4;0;1;2;6
86;1;5;8;0;0;3;11
86;1;6;9;0;3;1;10
86;1;7;3;0;2;4;7
86;1;8;0;0;0;2;2
86;1;9;0;0;0;0;0
86;1;10;0;0;0;0;0
86;1;11;0;0;0;0;0
86;1;12;0;0;0;0;0
86;1;13;2;0;1;2;4
86;1;14;1;0;0;1;2
86;1;15;0;0;0;0;0
86;1;16;0;0;0;0;0
86;1;17;0;0;0;0;0
86;1;18;0;0;0;0;0
86;1;19;0;0;0;0;0
86;1;20;0;0;0;0;0
88;1;1;0;0;0;0;0
88;1;2;2;0;0;5;7
88;1;3;2;0;0;6;8
88;1;4;7;2;0;12;19
88;1;5;1;0;0;3;4
88;1;6;0;0;0;1;1
88;1;7;0;0;0;0;0
88;1;8;0;0;0;0;0
88;1;9;0;0;0;0;0
88;1;10;0;0;0;3;3
88;1;11;2;1;0;4;6
88;1;12;7;3;0;17;24
88;1;13;6;3;0;19;25
88;1;14;1;1;0;12;13
88;1;15;2;0;0;3;5
88;1;16;0;0;0;2;2
88;1;17;0;0;0;1;1
88;1;18;0;0;0;0;0
88;1;19;0;0;0;0;0
88;1;20;0;0;0;0;0
89;1;1;0;0;0;0;0
89;1;2;0;0;0;3;3
89;1;3;1;1;0;7;8
89;1;4;1;0;0;7;8
89;1;5;0;0;0;5;5
89;1;6;1;0;0;5;6
89;1;7;1;0;0;1;2
89;1;8;0;0;0;2;2
89;1;9;0;1;0;2;2
89;1;10;0;0;0;1;1
89;1;11;0;0;0;1;1
89;1;12;1;0;0;1;2
89;1;13;0;0;0;0;0
89;1;14;0;0;0;0;0
89;1;15;0;0;0;0;0
89;1;16;0;0;0;0;0
89;1;17;0;0;0;0;0
89;1;18;0;1;0;2;2
89;1;19;2;0;0;3;5
89;1;20;2;2;0;5;7
89;1;21;3;2;0;4;7
89;1;22;0;0;0;5;5
89;1;23;1;0;0;2;3
89;1;24;0;1;0;4;4
89;1;25;2;1;0;0;2
89;1;26;0;0;0;1;1
89;1;27;0;0;0;0;0
89;1;28;0;0;0;0;0
89;1;29;0;0;0;0;0
89;1;30;0;0;0;0;0
89;1;31;0;0;0;0;0
89;1;32;0;0;0;0;0
89;1;33;0;0;0;0;0
89;1;34;0;0;0;0;0
89;1;35;0;0;0;0;0
89;1;36;0;0;0;0;0
89;1;37;0;0;0;0;0
89;1;38;0;0;0;0;0
89;1;39;0;0;0;0;0
89;1;40;0;0;0;0;0
90;1;1;0;0;0;0;0
90;1;2;0;0;0;9;9
90;1;3;0;0;0;10;10
90;1;4;0;0;0;13;13
90;1;5;0;0;0;5;5
90;1;6;0;0;0;4;4
90;1;7;0;0;0;0;0
90;1;8;0;0;0;0;0
90;1;9;0;0;0;0;0
90;1;10;0;0;0;1;1
90;1;11;0;0;0;3;3
90;1;12;0;0;0;6;6
90;1;13;0;0;0;3;3
90;1;14;0;0;0;3;3
90;1;15;0;0;0;0;0
90;1;16;0;0;0;0;0
90;1;17;0;0;0;0;0
90;1;18;0;0;0;0;0
90;1;19;0;0;0;0;0
90;1;20;0;0;0;0;0
91;1;1;0;0;0;0;0
91;1;2;0;0;0;0;0
91;1;3;0;0;0;0;0
91;1;4;0;0;0;1;1
91;1;5;3;0;0;2;5
91;1;6;4;1;0;6;10
91;1;7;4;1;0;4;8
91;1;8;2;1;0;6;8
91;1;9;2;0;0;3;5
91;1;10;0;0;0;2;2
91;1;11;0;0;0;2;2
91;1;12;0;0;0;1;1
91;1;13;0;0;0;1;1
91;1;14;0;0;0;2;2
91;1;15;0;0;0;0;0
91;1;16;0;0;0;0;0
91;1;17;0;0;0;0;0
91;1;18;0;0;0;0;0
91;1;19;1;0;0;2;3
91;1;20;0;0;0;7;7
91;1;21;0;0;0;4;4
91;1;22;1;0;0;4;5
91;1;23;0;0;0;5;5
91;1;24;1;1;0;4;5
91;1;25;2;1;0;4;6
91;1;26;0;2;0;3;3
91;1;27;0;0;0;1;1
91;1;28;0;0;0;1;1
91;1;29;0;0;0;0;0
91;1;30;0;0;0;0;0
91;1;31;0;0;0;0;0
91;1;32;0;0;0;0;0
91;1;33;0;0;0;0;0
91;1;34;0;0;0;0;0
91;1;35;0;0;0;0;0
91;1;36;0;0;0;0;0
91;1;37;0;0;0;0;0
91;1;38;0;0;0;0;0
91;1;39;0;0;0;0;0
91;1;40;0;0;0;0;0
92;1;1;0;0;0;0;0
92;1;2;0;0;0;1;1
92;1;3;5;1;0;7;12
92;1;4;4;2;2;5;9
92;1;5;11;4;2;5;16
92;1;6;5;1;1;5;10
92;1;7;2;0;0;3;5
92;1;8;1;0;0;2;3
92;1;9;1;0;0;0;1
92;1;10;1;0;0;1;2
92;1;11;1;1;0;0;1
92;1;12;1;1;0;0;1
92;1;13;2;0;0;0;2
92;1;14;0;0;0;1;1
92;1;15;3;1;0;0;3
92;1;16;0;0;0;0;0
92;1;17;0;0;0;0;0
92;1;18;0;0;0;0;0
92;1;19;0;0;0;0;0
92;1;20;0;0;0;0;0
94;1;1;0;0;0;0;0
94;1;2;0;0;0;4;4
94;1;3;0;0;0;6;6
94;1;4;0;0;0;11;11
94;1;5;0;0;0;14;14
94;1;6;0;0;0;8;8
94;1;7;0;0;0;5;5
94;1;8;0;0;0;3;3
94;1;9;0;0;0;0;0
94;1;10;0;0;0;0;0
94;1;11;0;0;0;0;0
94;1;12;0;0;0;3;3
94;1;13;0;0;0;7;7
94;1;14;0;0;0;6;6
94;1;15;0;0;0;4;4
94;1;16;0;0;0;0;0
94;1;17;0;0;0;0;0
94;1;18;0;0;0;0;0
94;1;19;0;0;0;0;0
94;1;20;0;0;0;0;0
96;1;1;0;0;0;4;4
96;1;2;0;0;0;28;28
96;1;3;1;0;0;14;15
96;1;4;0;0;0;4;4
96;1;5;1;1;0;3;4
96;1;6;0;0;0;3;3
96;1;7;0;0;0;2;2
96;1;8;0;0;0;1;1
96;1;9;0;0;0;1;1
96;1;10;0;0;0;4;4
96;1;11;0;0;0;5;5
96;1;12;0;0;0;3;3
96;1;13;0;0;0;3;3
96;1;14;0;0;0;3;3
96;1;15;0;0;0;2;2
96;1;16;0;0;0;0;0
96;1;17;0;0;0;0;0
96;1;18;0;0;0;0;0
96;1;19;0;0;0;0;0
96;1;20;0;0;0;0;0
99;1;1;0;0;0;0;0
99;1;2;0;0;0;0;0
99;1;3;2;0;0;0;2
99;1;4;11;6;0;10;21
99;1;5;4;4;0;5;9
99;1;6;3;3;0;7;10
99;1;7;2;1;0;2;4
99;1;8;0;0;0;1;1
99;1;9;0;0;0;1;1
99;1;10;0;0;0;2;2
99;1;11;0;0;0;2;2
99;1;12;2;1;0;4;6
99;1;13;1;1;0;8;9
99;1;14;5;1;0;4;9
99;1;15;6;1;0;3;9
99;1;16;2;2;0;5;7
99;1;17;1;0;0;3;4
99;1;18;0;0;0;0;0
99;1;19;0;0;0;0;0
99;1;20;0;0;0;0;0
100;1;1;0;0;0;1;1
100;1;2;3;1;0;2;5
100;1;3;2;0;0;2;4
100;1;4;2;0;0;4;6
100;1;5;2;0;0;5;7
100;1;6;2;0;0;6;8
100;1;7;1;0;0;2;3
100;1;8;0;0;0;0;0
100;1;9;0;0;0;0;0
100;1;10;0;0;0;6;6
100;1;11;0;0;0;7;7
100;1;12;1;0;0;9;10
100;1;13;0;0;0;6;6
100;1;14;0;0;0;3;3
100;1;15;0;0;0;1;1
100;1;16;0;0;0;1;1
100;1;17;0;0;0;1;1
100;1;18;0;0;0;0;0
100;1;19;0;0;0;0;0
100;1;20;0;0;0;0;0
101;1;1;0;0;0;0;0
101;1;2;0;0;0;0;0
101;1;3;3;1;0;8;11
101;1;4;2;0;0;8;10
101;1;5;1;0;0;9;10
101;1;6;1;1;0;7;8
101;1;7;0;0;0;5;5
101;1;8;0;0;0;5;5
101;1;9;0;0;0;5;5
101;1;10;0;0;0;3;3
101;1;11;0;0;0;2;2
101;1;12;1;3;0;2;3
101;1;13;5;2;0;7;12
101;1;14;7;2;0;5;12
101;1;15;5;1;0;7;12
101;1;16;3;0;0;3;6
101;1;17;1;0;0;2;3
101;1;18;0;0;0;1;1
101;1;19;0;0;0;0;0
101;1;20;0;0;0;0;0
102;1;1;0;0;0;0;0
102;1;2;0;0;0;0;0
102;1;3;0;0;0;0;0
102;1;4;1;0;0;9;10
102;1;5;0;0;0;23;23
102;1;6;0;0;0;7;7
102;1;7;0;0;0;4;4
102;1;8;0;0;0;1;1
102;1;9;0;0;0;1;1
102;1;10;0;0;0;0;0
102;1;11;0;0;0;0;0
102;1;12;0;0;0;0;0
102;1;13;0;0;0;7;7
102;1;14;0;0;0;6;6
102;1;15;0;0;0;4;4
102;1;16;0;0;0;2;2
102;1;17;0;0;0;0;0
102;1;18;0;0;0;0;0
102;1;19;0;0;0;0;0
102;1;20;0;0;0;0;0
103;1;1;0;0;0;0;0
103;1;2;0;0;0;0;0
103;1;3;3;1;0;4;7
103;1;4;3;1;0;5;8
103;1;5;2;0;0;7;9
103;1;6;2;2;0;4;6
103;1;7;0;0;0;1;1
103;1;8;0;0;0;0;0
103;1;9;0;0;0;0;0
103;1;10;0;0;0;0;0
103;1;11;0;0;0;0;0
103;1;12;0;0;0;3;3
103;1;13;5;2;0;8;13
103;1;14;2;0;0;7;9
103;1;15;3;0;0;8;11
103;1;16;0;0;0;7;7
103;1;17;0;0;0;2;2
103;1;18;0;0;0;1;1
103;1;19;0;0;0;0;0
103;1;20;0;0;0;0;0
106;1;1;0;0;0;0;0
106;1;2;1;1;0;0;1
106;1;3;3;2;0;7;10
106;1;4;3;2;0;9;12
106;1;5;1;1;0;2;3
106;1;6;0;0;0;1;1
106;1;7;0;0;0;0;0
106;1;8;0;0;0;0;0
106;1;9;0;0;0;0;0
106;1;10;0;0;0;3;3
106;1;11;3;1;0;5;8
106;1;12;6;3;0;9;15
106;1;13;10;7;0;8;18
106;1;14;5;1;0;3;8
106;1;15;1;2;0;2;3
106;1;16;2;1;0;1;3
106;1;17;0;0;0;0;0
106;1;18;0;0;0;0;0
106;1;19;0;0;0;0;0
106;1;20;0;0;0;0;0
107;1;1;0;0;0;0;0
107;1;2;0;0;0;0;0
107;1;3;0;0;0;0;0
107;1;4;0;0;0;7;7
107;1;5;0;0;0;19;19
107;1;6;0;0;0;14;14
107;1;7;0;0;0;10;10
107;1;8;0;0;0;5;5
107;1;9;0;0;0;1;1
107;1;10;0;0;0;0;0
107;1;11;0;0;0;0;0
107;1;12;0;0;0;0;0
107;1;13;0;0;0;7;7
107;1;14;0;1;0;10;10
107;1;15;0;0;0;15;15
107;1;16;0;0;0;4;4
107;1;17;0;0;0;2;2
107;1;18;0;0;0;0;0
107;1;19;0;0;0;0;0
107;1;20;0;0;0;0;0
109;1;1;0;0;0;0;0
109;1;2;1;0;0;2;3
109;1;3;3;0;0;8;11
109;1;4;2;0;0;7;9
109;1;5;1;0;0;6;7
109;1;6;3;0;0;3;6
109;1;7;3;2;0;5;8
109;1;8;0;0;0;0;0
109;1;9;0;0;0;0;0
109;1;10;2;1;0;3;5
109;1;11;2;1;0;2;4
109;1;12;1;2;0;4;5
109;1;13;3;1;0;9;12
109;1;14;3;1;0;7;10
109;1;15;3;2;0;5;8
109;1;16;1;0;0;2;3
109;1;17;2;1;0;2;4
109;1;18;0;1;0;3;3
109;1;19;0;0;0;0;0
109;1;20;0;0;0;0;0
110;1;1;0;0;0;0;0
110;1;2;4;1;0;3;7
110;1;3;5;0;0;7;12
110;1;4;3;0;0;6;9
110;1;5;1;0;0;3;4
110;1;6;1;0;0;4;5
110;1;7;2;0;0;1;3
110;1;8;0;0;0;0;0
110;1;9;0;0;0;1;1
110;1;10;1;0;0;11;12
110;1;11;1;0;0;4;5
110;1;12;3;0;0;7;10
110;1;13;6;0;0;10;16
110;1;14;7;0;0;8;15
110;1;15;2;0;0;3;5
110;1;16;0;0;0;2;2
110;1;17;0;0;0;0;0
110;1;18;0;0;0;0;0
110;1;19;0;0;0;0;0
110;1;20;0;0;0;0;0
111;1;1;0;0;0;0;0
111;1;2;0;0;0;0;0
111;1;3;0;0;0;1;1
111;1;4;0;0;0;3;3
111;1;5;1;0;0;2;3
111;1;6;3;0;0;3;6
111;1;7;5;0;0;8;13
111;1;8;3;1;2;6;9
111;1;9;3;1;1;6;9
111;1;10;3;1;0;5;8
111;1;11;1;0;0;4;5
111;1;12;0;0;0;1;1
111;1;13;1;0;0;3;4
111;1;14;0;0;0;1;1
111;1;15;0;0;0;1;1
111;1;16;0;0;0;1;1
111;1;17;0;1;0;1;1
111;1;18;0;0;0;3;3
111;1;19;0;0;0;3;3
111;1;20;0;0;0;2;2
111;1;21;0;0;0;3;3
111;1;22;0;0;0;1;1
111;1;23;2;1;0;1;3
111;1;24;2;0;0;1;3
111;1;25;1;0;0;1;2
111;1;26;1;2;0;1;2
111;1;27;0;0;0;0;0
111;1;28;0;0;0;0;0
111;1;29;0;0;0;0;0
111;1;30;0;0;0;0;0
111;1;31;0;0;0;0;0
111;1;32;0;0;0;0;0
111;1;33;0;0;0;0;0
111;1;34;0;0;0;0;0
111;1;35;0;0;0;0;0
111;1;36;0;0;0;0;0
111;1;37;0;0;0;0;0
111;1;38;0;0;0;0;0
111;1;39;0;0;0;0;0
111;1;40;0;0;0;0;0
114;1;1;0;0;0;0;0
114;1;2;0;0;0;0;0
114;1;3;0;0;0;0;0
114;1;4;0;0;0;0;0
114;1;5;0;0;0;5;5
114;1;6;2;2;1;8;10
114;1;7;1;0;1;6;7
114;1;8;3;2;0;5;8
114;1;9;0;0;0;3;3
114;1;10;0;0;0;4;4
114;1;11;0;0;0;2;2
114;1;12;0;0;0;1;1
114;1;13;0;0;0;0;0
114;1;14;0;0;0;0;0
114;1;15;0;0;0;0;0
114;1;16;0;0;0;0;0
114;1;17;0;0;0;0;0
114;1;18;0;0;0;0;0
114;1;19;0;0;0;0;0
114;1;20;0;0;0;0;0
114;1;21;0;1;0;1;1
114;1;22;1;0;1;1;2
114;1;23;1;1;0;1;2
114;1;24;1;1;0;2;3
114;1;25;0;0;0;2;2
114;1;26;1;0;0;1;2
114;1;27;0;0;0;0;0
114;1;28;0;0;0;0;0
114;1;29;0;0;0;0;0
114;1;30;0;0;0;0;0
114;1;31;0;0;0;0;0
114;1;32;0;0;0;0;0
114;1;33;0;0;0;0;0
114;1;34;0;0;0;0;0
114;1;35;0;0;0;0;0
114;1;36;0;0;0;0;0
114;1;37;0;0;0;0;0
114;1;38;0;0;0;0;0
114;1;39;0;0;0;0;0
114;1;40;0;0;0;0;0
117;1;1;0;0;0;0;0
117;1;2;0;0;0;0;0
117;1;3;0;0;0;2;2
117;1;4;0;0;0;3;3
117;1;5;0;0;0;19;19
117;1;6;0;0;0;14;14
117;1;7;0;0;0;11;11
117;1;8;0;0;0;6;6
117;1;9;0;0;0;3;3
117;1;10;0;0;0;2;2
117;1;11;0;0;0;0;0
117;1;12;0;0;0;0;0
117;1;13;0;0;0;0;0
117;1;14;0;0;0;0;0
117;1;15;0;0;0;0;0
117;1;16;0;0;0;0;0
117;1;17;0;0;0;0;0
117;1;18;0;0;0;5;5
117;1;19;0;0;0;8;8
117;1;20;0;0;0;4;4
117;1;21;0;0;0;5;5
117;1;22;0;0;0;2;2
117;1;23;0;0;0;0;0
117;1;24;0;0;0;0;0
117;1;25;0;0;0;0;0
117;1;26;0;0;0;0;0
117;1;27;0;0;0;0;0
117;1;28;0;0;0;0;0
117;1;29;0;0;0;0;0
117;1;30;0;0;0;0;0
117;1;31;0;0;0;0;0
117;1;32;0;0;0;0;0
117;1;33;0;0;0;0;0
117;1;34;0;0;0;0;0
117;1;35;0;0;0;0;0
117;1;36;0;0;0;0;0
117;1;37;0;0;0;0;0
117;1;38;0;0;0;0;0
117;1;39;0;0;0;0;0
117;1;40;0;0;0;0;0
118;1;1;0;0;0;0;0
118;1;2;0;0;0;0;0
118;1;3;0;0;0;1;1
118;1;4;0;0;0;4;4
118;1;5;1;0;0;8;9
118;1;6;3;0;0;3;6
118;1;7;2;0;0;5;7
118;1;8;2;1;0;4;6
118;1;9;2;1;0;2;4
118;1;10;3;0;0;1;4
118;1;11;2;0;0;2;4
118;1;12;2;0;0;0;2
118;1;13;0;0;0;2;2
118;1;14;0;0;0;1;1
118;1;15;0;0;0;0;0
118;1;16;0;0;0;0;0
118;1;17;0;0;0;0;0
118;1;18;0;0;0;0;0
118;1;19;0;0;0;0;0
118;1;20;0;0;0;0;0
118;1;21;0;0;0;0;0
118;1;22;2;0;0;1;3
118;1;23;2;0;0;4;6
118;1;24;0;0;0;1;1
118;1;25;0;1;0;1;1
118;1;26;0;0;0;3;3
118;1;27;0;0;0;1;1
118;1;28;0;0;0;1;1
118;1;29;0;0;0;0;0
118;1;30;0;0;0;0;0
118;1;31;0;0;0;0;0
118;1;32;0;0;0;0;0
118;1;33;0;0;0;0;0
118;1;34;0;0;0;0;0
118;1;35;0;0;0;0;0
118;1;36;0;0;0;0;0
118;1;37;0;0;0;0;0
118;1;38;0;0;0;0;0
118;1;39;0;0;0;0;0
118;1;40;0;0;0;0;0
123;1;1;0;0;0;0;0
123;1;2;0;0;0;2;2
123;1;3;0;2;0;13;13
123;1;4;0;1;0;11;11
123;1;5;1;0;0;5;6
123;1;6;0;0;0;1;1
123;1;7;0;0;0;1;1
123;1;8;0;0;0;0;0
123;1;9;0;0;0;0;0
123;1;10;0;0;0;0;0
123;1;11;0;0;0;2;2
123;1;12;0;0;0;10;10
123;1;13;1;1;0;15;16
123;1;14;1;1;0;8;9
123;1;15;0;0;0;2;2
123;1;16;0;0;0;0;0
123;1;17;0;0;0;0;0
123;1;18;0;0;0;0;0
123;1;19;0;0;0;0;0
123;1;20;0;0;0;0;0
127;1;1;0;0;0;0;0
127;1;2;0;0;0;0;0
127;1;3;0;1;0;1;1
127;1;4;2;3;0;6;8
127;1;5;4;2;0;7;11
127;1;6;1;1;0;11;12
127;1;7;4;0;0;8;12
127;1;8;2;0;0;15;17
127;1;9;4;2;0;7;11
127;1;10;3;1;0;1;4
127;1;11;1;0;0;1;2
127;1;12;1;2;0;3;4
127;1;13;1;1;0;2;3
127;1;14;1;2;1;1;2
127;1;15;6;8;0;6;12
127;1;16;2;1;0;3;5
127;1;17;1;1;0;1;2
127;1;18;0;0;0;1;1
127;1;19;0;0;0;0;0
127;1;20;0;0;0;0;0
129;1;1;0;0;0;0;0
129;1;2;0;0;0;5;5
129;1;3;2;0;0;13;15
129;1;4;2;0;0;10;12
129;1;5;1;0;0;12;13
129;1;6;0;0;0;7;7
129;1;7;0;0;0;4;4
129;1;8;0;0;0;5;5
129;1;9;0;0;0;5;5
129;1;10;0;0;0;3;3
129;1;11;0;0;0;0;0
129;1;12;0;0;0;2;2
129;1;13;0;0;0;3;3
129;1;14;0;0;0;6;6
129;1;15;0;0;0;6;6
129;1;16;0;0;0;4;4
129;1;17;0;0;0;1;1
129;1;18;0;0;0;0;0
129;1;19;0;0;0;0;0
129;1;20;0;0;0;0;0
131;1;1;0;0;0;0;0
131;1;2;0;0;0;2;2
131;1;3;4;2;0;5;9
131;1;4;0;0;0;12;12
131;1;5;0;0;0;14;14
131;1;6;0;0;0;3;3
131;1;7;0;0;0;2;2
131;1;8;0;0;0;2;2
131;1;9;0;0;0;1;1
131;1;10;0;0;0;0;0
131;1;11;0;0;0;0;0
131;1;12;1;2;0;1;2
131;1;13;2;1;0;5;7
131;1;14;4;3;0;3;7
131;1;15;2;2;0;1;3
131;1;16;0;0;0;0;0
131;1;17;0;0;0;0;0
131;1;18;0;0;0;0;0
131;1;19;0;0;0;0;0
131;1;20;0;0;0;0;0
135;1;1;0;0;0;0;0
135;1;2;1;1;0;0;1
135;1;3;5;4;0;4;9
135;1;4;11;4;0;9;20
135;1;5;7;5;0;10;17
135;1;6;10;2;0;11;21
135;1;7;6;4;0;5;11
135;1;8;1;1;0;3;4
135;1;9;0;0;0;2;2
135;1;10;0;0;0;0;0
135;1;11;0;0;0;0;0
135;1;12;0;0;0;0;0
135;1;13;3;2;0;3;6
135;1;14;13;8;0;7;20
135;1;15;10;8;0;5;15
135;1;16;10;4;0;7;17
135;1;17;6;5;0;7;13
135;1;18;0;1;0;2;2
135;1;19;0;0;0;0;0
135;1;20;0;0;0;0;0
138;1;1;0;0;0;0;0
138;1;2;0;0;0;0;0
138;1;3;0;0;0;1;1
138;1;4;1;0;0;1;2
138;1;5;0;0;0;4;4
138;1;6;3;2;0;7;10
138;1;7;1;2;0;7;8
138;1;8;1;1;0;6;7
138;1;9;0;1;0;6;6
138;1;10;0;1;0;7;7
138;1;11;1;1;0;4;5
138;1;12;0;0;0;4;4
138;1;13;0;0;0;2;2
138;1;14;0;0;0;0;0
138;1;15;0;0;0;0;0
138;1;16;0;0;0;0;0
138;1;17;0;0;0;0;0
138;1;18;0;0;0;1;1
138;1;19;0;0;0;1;1
138;1;20;0;0;0;1;1
138;1;21;0;0;0;1;1
138;1;22;0;0;0;2;2
138;1;23;0;0;0;2;2
138;1;24;0;0;0;4;4
138;1;25;0;0;0;1;1
138;1;26;0;0;0;1;1
138;1;27;1;1;0;1;2
138;1;28;0;0;0;1;1
138;1;29;0;0;0;0;0
138;1;30;1;1;0;0;1
138;1;31;0;0;0;0;0
138;1;32;0;0;0;0;0
138;1;33;0;0;0;0;0
138;1;34;0;0;0;0;0
138;1;35;0;0;0;0;0
138;1;36;0;0;0;0;0
138;1;37;0;0;0;0;0
138;1;38;0;0;0;0;0
138;1;39;0;0;0;0;0
138;1;40;0;0;0;0;0
139;1;1;0;0;0;0;0
139;1;2;0;0;0;0;0
139;1;3;0;0;0;0;0
139;1;4;0;0;0;0;0
139;1;5;0;0;0;1;1
139;1;6;1;0;0;7;8
139;1;7;0;0;0;6;6
139;1;8;0;0;0;5;5
139;1;9;0;0;0;8;8
139;1;10;0;0;0;5;5
139;1;11;0;0;0;8;8
139;1;12;0;0;0;5;5
139;1;13;0;0;0;1;1
139;1;14;0;0;0;1;1
139;1;15;0;0;0;0;0
139;1;16;0;0;0;0;0
139;1;17;0;0;0;0;0
139;1;18;0;0;0;0;0
139;1;19;0;0;0;0;0
139;1;20;0;0;0;0;0
139;1;21;0;0;0;0;0
139;1;22;0;0;0;0;0
139;1;23;0;0;0;6;6
139;1;24;0;0;0;4;4
139;1;25;0;0;0;2;2
139;1;26;1;0;0;1;2
139;1;27;0;0;0;2;2
139;1;28;0;0;0;1;1
139;1;29;0;0;0;0;0
139;1;30;0;0;0;0;0
139;1;31;0;0;0;0;0
139;1;32;0;0;0;0;0
139;1;33;0;0;0;0;0
139;1;34;0;0;0;0;0
139;1;35;0;0;0;0;0
139;1;36;0;0;0;0;0
139;1;37;0;0;0;0;0
139;1;38;0;0;0;0;0
139;1;39;0;0;0;0;0
139;1;40;0;0;0;0;0
143;1;1;0;0;0;0;0
143;1;2;0;0;0;3;3
143;1;3;0;0;0;11;11
143;1;4;0;0;0;8;8
143;1;5;0;0;0;6;6
143;1;6;0;0;0;6;6
143;1;7;0;0;0;0;0
143;1;8;0;0;0;0;0
143;1;9;0;0;0;0;0
143;1;10;0;0;0;10;10
143;1;11;0;0;0;16;16
143;1;12;0;0;0;7;7
143;1;13;0;0;0;5;5
143;1;14;0;0;0;2;2
143;1;15;0;0;0;0;0
143;1;16;0;0;0;0;0
143;1;17;0;0;0;0;0
143;1;18;0;0;0;0;0
143;1;19;0;0;0;0;0
143;1;20;0;0;0;0;0
144;1;1;0;0;0;0;0
144;1;2;0;0;0;0;0
144;1;3;0;0;0;3;3
144;1;4;0;0;0;4;4
144;1;5;0;0;0;6;6
144;1;6;0;0;0;7;7
144;1;7;0;0;0;9;9
144;1;8;0;1;0;8;8
144;1;9;0;0;0;5;5
144;1;10;0;0;0;1;1
144;1;11;0;0;0;0;0
144;1;12;0;0;0;0;0
144;1;13;0;0;0;0;0
144;1;14;0;0;0;0;0
144;1;15;0;0;0;0;0
144;1;16;0;0;0;0;0
144;1;17;0;0;0;0;0
144;1;18;0;0;0;0;0
144;1;19;0;0;0;0;0
144;1;20;0;0;0;0;0
144;1;21;0;0;0;3;3
144;1;22;1;1;0;2;3
144;1;23;1;0;0;0;1
144;1;24;0;0;0;2;2
144;1;25;0;0;0;1;1
144;1;26;0;0;0;1;1
144;1;27;0;0;0;0;0
144;1;28;0;0;0;0;0
144;1;29;0;0;0;0;0
144;1;30;0;0;0;0;0
144;1;31;0;0;0;0;0
144;1;32;0;0;0;0;0
144;1;33;0;0;0;0;0
144;1;34;0;0;0;0;0
144;1;35;0;0;0;0;0
144;1;36;0;0;0;0;0
144;1;37;0;0;0;0;0
144;1;38;0;0;0;0;0
144;1;39;0;0;0;0;0
144;1;40;0;0;0;0;0
145;1;1;0;0;0;1;1
145;1;2;0;0;0;10;10
145;1;3;0;0;0;13;13
145;1;4;1;0;0;7;8
145;1;5;3;0;0;4;7
145;1;6;2;1;0;5;7
145;1;7;0;0;0;1;1
145;1;8;0;0;0;0;0
145;1;9;0;0;0;0;0
145;1;10;0;0;0;0;0
145;1;11;0;0;0;1;1
145;1;12;4;0;0;8;12
145;1;13;3;1;0;2;5
145;1;14;1;1;0;3;4
145;1;15;1;0;0;0;1
145;1;16;0;0;0;0;0
145;1;17;0;0;0;0;0
145;1;18;0;0;0;0;0
145;1;19;0;0;0;0;0
145;1;20;0;0;0;0;0
147;1;1;0;0;0;1;1
147;1;2;2;1;0;18;20
147;1;3;5;0;0;22;27
147;1;4;3;0;0;12;15
147;1;5;0;0;0;4;4
147;1;6;0;0;0;0;0
147;1;7;0;0;0;0;0
147;1;8;0;0;0;0;0
147;1;9;5;3;0;9;14
147;1;10;1;0;0;2;3
147;1;11;1;0;0;2;3
147;1;12;1;1;0;1;2
147;1;13;0;0;0;0;0
147;1;14;0;0;0;0;0
147;1;15;0;0;0;0;0
147;1;16;0;0;0;0;0
147;1;17;0;0;0;0;0
147;1;18;0;0;0;0;0
147;1;19;0;0;0;0;0
147;1;20;0;0;0;0;0
150;1;1;0;0;0;0;0
150;1;2;0;0;0;3;3
150;1;3;0;0;0;14;14
150;1;4;0;0;0;14;14
150;1;5;0;0;0;9;9
150;1;6;0;0;0;4;4
150;1;7;0;0;0;0;0
150;1;8;0;0;0;0;0
150;1;9;0;0;0;2;2
150;1;10;1;0;0;7;8
150;1;11;0;0;0;15;15
150;1;12;0;1;0;12;12
150;1;13;0;0;0;5;5
150;1;14;0;0;0;4;4
150;1;15;0;0;0;2;2
150;1;16;0;0;0;0;0
150;1;17;0;0;0;0;0
150;1;18;0;0;0;0;0
150;1;19;0;0;0;0;0
150;1;20;0;0;0;0;0
153;1;1;0;0;0;0;0
153;1;2;0;0;0;1;1
153;1;3;6;5;0;4;10
153;1;4;8;6;0;3;11
153;1;5;4;1;0;3;7
153;1;6;1;1;0;1;2
153;1;7;1;0;0;1;2
153;1;8;0;0;0;0;0
153;1;9;0;0;0;0;0
153;1;10;2;2;0;1;3
153;1;11;7;4;0;2;9
153;1;12;6;3;0;1;7
153;1;13;0;2;0;2;2
153;1;14;1;2;0;1;2
153;1;15;0;0;0;0;0
153;1;16;0;0;0;0;0
153;1;17;0;0;0;0;0
153;1;18;0;0;0;0;0
153;1;19;0;0;0;0;0
153;1;20;0;0;0;0;0
154;1;1;0;0;0;0;0
154;1;2;0;0;0;0;0
154;1;3;0;0;0;0;0
154;1;4;0;1;0;2;2
154;1;5;0;1;0;6;6
154;1;6;0;0;0;7;7
154;1;7;0;0;0;6;6
154;1;8;0;0;0;4;4
154;1;9;0;0;0;5;5
154;1;10;0;0;0;2;2
154;1;11;0;0;0;2;2
154;1;12;0;0;0;1;1
154;1;13;0;0;0;0;0
154;1;14;0;0;0;0;0
154;1;15;0;0;0;0;0
154;1;16;0;0;0;0;0
154;1;17;0;0;0;0;0
154;1;18;0;0;0;2;2
154;1;19;0;0;0;2;2
154;1;20;0;0;0;2;2
154;1;21;0;0;0;2;2
154;1;22;0;0;0;1;1
154;1;23;0;0;0;2;2
154;1;24;0;0;0;0;0
154;1;25;0;0;0;0;0
154;1;26;0;0;0;0;0
154;1;27;0;0;0;0;0
154;1;28;0;0;0;0;0
154;1;29;0;0;0;0;0
154;1;30;0;0;0;0;0
154;1;31;0;0;0;0;0
154;1;32;0;0;0;0;0
154;1;33;0;0;0;0;0
154;1;34;0;0;0;0;0
154;1;35;0;0;0;0;0
154;1;36;0;0;0;0;0
154;1;37;0;0;0;0;0
154;1;38;0;0;0;0;0
154;1;39;0;0;0;0;0
154;1;40;0;0;0;0;0
155;1;1;0;0;0;1;1
155;1;2;2;0;0;13;15
155;1;3;0;0;0;11;11
155;1;4;0;0;0;8;8
155;1;5;0;0;0;1;1
155;1;6;0;0;0;0;0
155;1;7;0;0;0;0;0
155;1;8;1;0;0;3;4
155;1;9;2;1;0;4;6
155;1;10;1;2;0;3;4
155;1;11;0;0;0;2;2
155;1;12;0;0;0;0;0
155;1;13;0;0;0;0;0
155;1;14;0;0;0;0;0
155;1;15;0;0;0;0;0
155;1;16;0;0;0;0;0
155;1;17;0;0;0;0;0
155;1;18;0;0;0;0;0
155;1;19;0;0;0;0;0
155;1;20;0;0;0;0;0
156;1;1;1;1;0;0;1
156;1;2;2;2;0;0;2
156;1;3;2;2;0;3;5
156;1;4;6;5;0;5;11
156;1;5;12;5;0;4;16
156;1;6;5;3;0;3;8
156;1;7;0;0;0;3;3
156;1;8;1;1;0;1;2
156;1;9;1;0;0;1;2
156;1;10;1;1;0;0;1
156;1;11;0;1;0;1;1
156;1;12;0;0;0;0;0
156;1;13;3;4;0;5;8
156;1;14;9;7;0;3;12
156;1;15;8;9;0;6;14
156;1;16;4;4;0;6;10
156;1;17;5;6;0;2;7
156;1;18;2;1;0;0;2
156;1;19;0;0;0;0;0
156;1;20;0;0;0;0;0
157;1;1;0;0;0;0;0
157;1;2;1;0;0;2;3
157;1;3;2;0;0;9;11
157;1;4;0;0;0;12;12
157;1;5;1;0;0;6;7
157;1;6;0;0;0;2;2
157;1;7;0;0;0;1;1
157;1;8;0;0;0;0;0
157;1;9;0;0;0;0;0
157;1;10;0;0;0;0;0
157;1;11;0;0;0;4;4
157;1;12;1;1;0;5;6
157;1;13;1;0;0;6;7
157;1;14;2;0;0;5;7
157;1;15;0;0;0;3;3
157;1;16;0;0;0;1;1
157;1;17;0;0;0;0;0
157;1;18;0;0;0;0;0
157;1;19;0;0;0;0;0
157;1;20;0;0;0;0;0
158;1;1;0;0;0;0;0
158;1;2;0;0;0;6;6
158;1;3;3;3;0;7;10
158;1;4;1;1;0;6;7
158;1;5;2;3;0;8;10
158;1;6;0;1;0;3;3
158;1;7;0;0;0;0;0
158;1;8;0;0;0;0;0
158;1;9;0;0;0;0;0
158;1;10;0;0;0;0;0
158;1;11;0;0;0;1;1
158;1;12;2;3;0;10;12
158;1;13;2;2;0;5;7
158;1;14;1;1;0;9;10
158;1;15;2;2;0;11;13
158;1;16;1;0;0;4;5
158;1;17;0;0;0;0;0
158;1;18;0;0;0;0;0
158;1;19;0;0;0;0;0
158;1;20;0;0;0;0;0
159;1;1;0;0;0;0;0
159;1;2;0;0;0;0;0
159;1;3;0;0;0;2;2
159;1;4;0;0;0;7;7
159;1;5;0;0;0;9;9
159;1;6;0;0;0;8;8
159;1;7;0;0;0;6;6
159;1;8;0;0;0;3;3
159;1;9;0;0;0;1;1
159;1;10;0;0;0;2;2
159;1;11;0;0;0;2;2
159;1;12;0;0;0;1;1
159;1;13;0;0;0;1;1
159;1;14;0;0;0;0;0
159;1;15;0;0;0;0;0
159;1;16;0;0;0;0;0
159;1;17;0;0;0;0;0
159;1;18;0;0;0;0;0
159;1;19;0;0;0;0;0
159;1;20;0;0;0;0;0
159;1;21;0;0;0;1;1
159;1;22;0;0;0;5;5
159;1;23;0;0;0;7;7
159;1;24;0;0;0;10;10
159;1;25;0;0;0;6;6
159;1;26;0;0;0;5;5
159;1;27;0;0;0;5;5
159;1;28;0;0;0;3;3
159;1;29;0;0;0;2;2
159;1;30;0;0;0;3;3
159;1;31;0;0;0;3;3
159;1;32;0;0;0;1;1
159;1;33;0;0;0;0;0
159;1;34;0;0;0;0;0
159;1;35;0;0;0;0;0
159;1;36;0;0;0;0;0
159;1;37;0;0;0;0;0
159;1;38;0;0;0;0;0
159;1;39;0;0;0;0;0
159;1;40;0;0;0;0;0
160;1;1;0;0;0;4;4
160;1;2;0;1;0;8;8
160;1;3;0;0;0;16;16
160;1;4;0;0;0;9;9
160;1;5;0;0;0;5;5
160;1;6;0;0;0;2;2
160;1;7;0;0;0;0;0
160;1;8;0;0;0;0;0
160;1;9;0;0;0;3;3
160;1;10;0;0;0;3;3
160;1;11;0;0;0;2;2
160;1;12;1;0;0;2;3
160;1;13;0;0;0;0;0
160;1;14;0;0;0;0;0
160;1;15;0;0;0;0;0
160;1;16;0;0;0;0;0
160;1;17;0;0;0;0;0
160;1;18;0;0;0;0;0
160;1;19;0;0;0;0;0
160;1;20;0;0;0;0;0
163;1;1;0;0;0;0;0
163;1;2;0;0;0;1;1
163;1;3;4;0;0;4;8
163;1;4;5;0;0;10;15
163;1;5;1;1;0;6;7
163;1;6;2;0;0;4;6
163;1;7;1;0;0;5;6
163;1;8;2;0;0;4;6
163;1;9;1;1;0;3;4
163;1;10;0;0;0;0;0
163;1;11;0;0;0;0;0
163;1;12;0;0;0;1;1
163;1;13;0;0;0;2;2
163;1;14;1;0;0;3;4
163;1;15;0;0;0;4;4
163;1;16;1;0;0;5;6
163;1;17;0;0;0;0;0
163;1;18;0;0;0;0;0
163;1;19;0;0;0;0;0
163;1;20;0;0;0;0;0
164;1;1;0;0;0;0;0
164;1;2;0;0;0;2;2
164;1;3;2;0;0;8;10
164;1;4;3;0;0;14;17
164;1;5;2;0;0;11;13
164;1;6;2;1;0;9;11
164;1;7;0;0;0;2;2
164;1;8;0;0;0;4;4
164;1;9;0;0;0;1;1
164;1;10;2;0;0;2;4
164;1;11;0;0;0;6;6
164;1;12;0;0;0;6;6
164;1;13;0;0;0;9;9
164;1;14;0;0;0;9;9
164;1;15;1;0;0;7;8
164;1;16;0;0;0;1;1
164;1;17;0;0;0;1;1
164;1;18;0;0;0;0;0
164;1;19;0;0;0;0;0
164;1;20;0;0;0;0;0
165;1;1;0;0;0;0;0
165;1;2;2;0;0;2;4
165;1;3;3;0;0;2;5
165;1;4;2;1;0;7;9
165;1;5;2;0;0;4;6
165;1;6;2;0;0;3;5
165;1;7;3;0;0;1;4
165;1;8;2;0;0;0;2
165;1;9;3;0;0;0;3
165;1;10;6;1;0;1;7
165;1;11;6;0;0;4;10
165;1;12;5;1;0;5;10
165;1;13;7;1;0;4;11
165;1;14;5;2;0;7;12
165;1;15;7;2;0;5;12
165;1;16;4;4;0;4;8
165;1;17;3;1;0;2;5
165;1;18;2;0;0;3;5
165;1;19;4;0;0;2;6
165;1;20;4;2;0;2;6
166;1;1;0;0;0;1;1
166;1;2;0;0;0;4;4
166;1;3;0;0;0;4;4
166;1;4;0;0;0;19;19
166;1;5;1;0;0;19;20
166;1;6;1;0;0;12;13
166;1;7;1;0;0;7;8
166;1;8;0;0;0;3;3
166;1;9;0;0;0;6;6
166;1;10;0;0;0;6;6
166;1;11;0;0;0;12;12
166;1;12;0;0;0;11;11
166;1;13;1;0;0;15;16
166;1;14;1;0;0;8;9
166;1;15;3;0;0;6;9
166;1;16;4;0;0;8;12
166;1;17;2;0;0;14;16
166;1;18;0;0;0;4;4
166;1;19;0;0;0;1;1
166;1;20;0;0;0;0;0
167;1;1;0;0;0;0;0
167;1;2;0;0;0;2;2
167;1;3;5;0;0;10;15
167;1;4;3;0;1;9;12
167;1;5;4;0;2;11;15
167;1;6;1;0;1;3;4
167;1;7;0;0;0;1;1
167;1;8;0;0;0;1;1
167;1;9;0;0;0;3;3
167;1;10;1;0;1;6;7
167;1;11;1;0;0;6;7
167;1;12;1;0;0;6;7
167;1;13;2;0;3;9;11
167;1;14;1;0;0;14;15
167;1;15;1;0;2;8;9
167;1;16;0;0;1;5;5
167;1;17;2;0;0;6;8
167;1;18;0;0;0;5;5
167;1;19;0;0;0;2;2
167;1;20;0;0;0;1;1
168;1;1;0;0;0;1;1
168;1;2;3;0;0;5;8
168;1;3;2;0;0;10;12
168;1;4;2;0;0;13;15
168;1;5;2;0;0;12;14
168;1;6;3;0;0;7;10
168;1;7;2;0;0;5;7
168;1;8;1;0;0;7;8
168;1;9;1;0;0;9;10
168;1;10;3;0;0;4;7
168;1;11;0;0;0;5;5
168;1;12;1;0;0;7;8
168;1;13;2;0;0;4;6
168;1;14;1;0;0;10;11
168;1;15;2;0;0;8;10
168;1;16;0;0;0;9;9
168;1;17;0;0;0;5;5
168;1;18;2;0;0;3;5
168;1;19;0;0;0;1;1
168;1;20;0;0;0;0;0
172;1;1;0;0;0;0;0
172;1;2;0;0;0;2;2
172;1;3;0;0;0;7;7
172;1;4;0;0;0;19;19
172;1;5;0;0;0;13;13
172;1;6;0;0;0;10;10
172;1;7;0;0;0;9;9
172;1;8;0;0;0;4;4
172;1;9;0;0;0;3;3
172;1;10;0;0;0;0;0
172;1;11;0;0;0;4;4
172;1;12;0;0;0;14;14
172;1;13;0;0;0;22;22
172;1;14;0;0;0;15;15
172;1;15;0;0;0;18;18
172;1;16;0;0;0;14;14
172;1;17;0;0;0;7;7
172;1;18;0;0;0;2;2
172;1;19;0;0;0;0;0
172;1;20;0;0;0;0;0
176;1;1;0;0;0;0;0
176;1;2;0;0;0;1;1
176;1;3;1;1;0;9;10
176;1;4;8;3;0;13;21
176;1;5;5;4;0;12;17
176;1;6;11;3;0;11;22
176;1;7;7;5;0;14;21
176;1;8;4;3;0;5;9
176;1;9;10;6;0;10;20
176;1;10;4;5;0;19;23
176;1;11;9;4;0;11;20
176;1;12;6;4;0;16;22
176;1;13;5;2;0;8;13
176;1;14;9;0;0;13;22
176;1;15;4;1;0;6;10
176;1;16;4;1;0;5;9
176;1;17;0;1;0;3;3
176;1;18;0;1;0;2;2
176;1;19;2;0;0;0;2
176;1;20;1;0;0;1;2
177;1;1;0;0;0;0;0
177;1;2;0;0;0;1;1
177;1;3;0;0;2;13;13
177;1;4;2;0;0;20;22
177;1;5;0;0;0;10;10
177;1;6;0;0;0;12;12
177;1;7;0;0;0;10;10
177;1;8;0;0;0;6;6
177;1;9;0;0;0;7;7
177;1;10;0;0;0;1;1
177;1;11;0;0;0;0;0
177;1;12;0;0;0;2;2
177;1;13;0;0;0;3;3
177;1;14;0;0;0;5;5
177;1;15;0;0;0;3;3
177;1;16;0;0;0;3;3
177;1;17;0;0;0;4;4
177;1;18;0;0;0;0;0
177;1;19;0;0;0;0;0
177;1;20;0;0;0;0;0
169;1;1;0;0;0;1;1
169;1;2;1;0;0;7;8
169;1;3;0;0;0;16;16
169;1;4;2;0;0;11;13
169;1;5;2;0;0;8;10
169;1;6;1;0;0;6;7
169;1;7;0;0;0;5;5
169;1;8;0;0;0;9;9
169;1;9;1;0;0;10;11
169;1;10;0;0;0;0;0
169;1;11;0;0;0;2;2
169;1;12;0;0;0;5;5
169;1;13;1;0;0;8;9
169;1;14;1;0;0;14;15
169;1;15;0;0;0;10;10
169;1;16;0;0;0;8;8
169;1;17;0;0;0;4;4
169;1;18;0;0;0;0;0
169;1;19;0;0;0;0;0
169;1;20;0;0;0;0;0
180;1;1;0;0;0;0;0
180;1;2;5;3;0;2;7
180;1;3;5;3;0;6;11
180;1;4;7;2;0;5;12
180;1;5;6;1;0;9;15
180;1;6;3;3;0;2;5
180;1;7;3;2;0;2;5
180;1;8;4;0;0;2;6
180;1;9;2;2;0;1;3
180;1;10;0;0;0;0;0
180;1;11;0;0;0;0;0
180;1;12;0;0;0;0;0
180;1;13;0;0;0;1;1
180;1;14;3;2;0;3;6
180;1;15;6;5;0;3;9
180;1;16;5;3;0;4;9
180;1;17;0;1;0;3;3
180;1;18;0;0;0;0;0
180;1;19;0;0;0;0;0
180;1;20;0;0;0;0;0
181;1;1;0;0;0;0;0
181;1;2;1;3;0;6;7
181;1;3;10;6;0;8;18
181;1;4;3;0;0;14;17
181;1;5;0;0;0;9;9
181;1;6;1;0;0;2;3
181;1;7;0;0;0;0;0
181;1;8;0;0;0;0;0
181;1;9;0;0;0;0;0
181;1;10;0;0;0;0;0
181;1;11;0;0;0;3;3
181;1;12;0;0;0;3;3
181;1;13;1;0;0;8;9
181;1;14;0;0;0;4;4
181;1;15;0;0;0;2;2
181;1;16;0;0;0;3;3
181;1;17;0;0;0;1;1
181;1;18;0;0;0;0;0
181;1;19;0;0;0;0;0
181;1;20;0;0;0;0;0
183;1;1;0;0;0;0;0
183;1;2;0;0;0;1;1
183;1;3;1;0;0;19;20
183;1;4;0;0;0;13;13
183;1;5;1;0;0;15;16
183;1;6;2;0;0;8;10
183;1;7;2;0;0;12;14
183;1;8;0;0;0;10;10
183;1;9;0;0;0;5;5
183;1;10;1;0;0;4;5
183;1;11;0;0;0;13;13
183;1;12;0;0;0;5;5
183;1;13;2;0;0;6;8
183;1;14;0;0;0;14;14
183;1;15;0;0;0;4;4
183;1;16;1;0;0;4;5
183;1;17;0;0;0;0;0
183;1;18;0;0;0;0;0
183;1;19;0;0;0;0;0
183;1;20;0;0;0;0;0
185;1;1;0;0;0;0;0
185;1;2;0;0;0;4;4
185;1;3;0;0;0;27;27
185;1;4;0;0;0;19;19
185;1;5;0;0;0;21;21
185;1;6;0;0;0;11;11
185;1;7;0;0;0;5;5
185;1;8;0;0;0;2;2
185;1;9;0;0;0;0;0
185;1;10;0;0;0;0;0
185;1;11;0;0;0;10;10
185;1;12;0;0;0;18;18
185;1;13;0;0;0;12;12
185;1;14;0;0;0;7;7
185;1;15;0;0;0;3;3
185;1;16;0;0;0;0;0
185;1;17;0;0;0;0;0
185;1;18;0;0;0;0;0
185;1;19;0;0;0;0;0
185;1;20;0;0;0;0;0
186;1;1;0;0;0;1;1
186;1;2;0;0;0;11;11
186;1;3;1;0;0;19;20
186;1;4;1;0;0;15;16
186;1;5;1;0;0;8;9
186;1;6;0;0;0;6;6
186;1;7;0;0;0;7;7
186;1;8;0;0;0;1;1
186;1;9;0;0;0;1;1
186;1;10;0;0;0;3;3
186;1;11;1;0;0;7;8
186;1;12;1;0;0;12;13
186;1;13;0;0;0;10;10
186;1;14;0;0;0;6;6
186;1;15;0;0;0;9;9
186;1;16;1;0;0;7;8
186;1;17;0;0;0;7;7
186;1;18;0;0;0;4;4
186;1;19;0;0;0;3;3
186;1;20;0;0;0;5;5
187;1;1;0;0;0;0;0
187;1;2;1;0;0;3;4
187;1;3;0;0;0;7;7
187;1;4;1;0;0;11;12
187;1;5;1;0;0;10;11
187;1;6;0;0;0;7;7
187;1;7;0;0;0;7;7
187;1;8;0;0;0;5;5
187;1;9;0;0;0;2;2
187;1;10;1;0;0;1;2
187;1;11;0;0;0;1;1
187;1;12;0;0;0;13;13
187;1;13;6;1;0;5;11
187;1;14;1;0;0;8;9
187;1;15;2;0;0;2;4
187;1;16;1;0;0;3;4
187;1;17;0;0;0;2;2
187;1;18;0;0;0;1;1
187;1;19;0;0;0;0;0
187;1;20;0;0;0;0;0
188;1;1;0;0;0;0;0
188;1;2;3;2;0;0;3
188;1;3;6;1;0;4;10
188;1;4;5;1;0;5;10
188;1;5;5;0;0;7;12
188;1;6;2;0;0;7;9
188;1;7;3;2;0;2;5
188;1;8;3;3;0;2;5
188;1;9;1;1;0;2;3
188;1;10;1;0;0;4;5
188;1;11;0;1;0;3;3
188;1;12;0;0;0;2;2
188;1;13;1;0;0;3;4
188;1;14;0;0;0;3;3
188;1;15;6;1;0;11;17
188;1;16;4;2;0;10;14
188;1;17;1;1;0;5;6
188;1;18;2;1;0;2;4
188;1;19;2;1;0;0;2
188;1;20;0;0;0;0;0
190;1;1;0;0;0;0;0
190;1;2;0;0;0;0;0
190;1;3;5;1;0;8;13
190;1;4;5;0;4;9;14
190;1;5;3;0;1;10;13
190;1;6;2;0;1;8;10
190;1;7;2;0;1;4;6
190;1;8;1;0;0;1;2
190;1;9;0;0;0;0;0
190;1;10;0;0;0;0;0
190;1;11;0;0;0;0;0
190;1;12;1;0;1;3;4
190;1;13;1;0;1;1;2
190;1;14;1;0;1;1;2
190;1;15;2;0;0;0;2
190;1;16;0;0;0;0;0
190;1;17;0;0;0;0;0
190;1;18;0;0;0;0;0
190;1;19;0;0;0;0;0
190;1;20;0;0;0;0;0
191;1;1;0;0;0;0;0
191;1;2;1;0;0;2;3
191;1;3;0;0;0;9;9
191;1;4;1;0;0;8;9
191;1;5;2;0;0;8;10
191;1;6;2;0;0;8;10
191;1;7;3;0;0;8;11
191;1;8;2;0;0;8;10
191;1;9;0;0;0;10;10
191;1;10;3;0;0;6;9
191;1;11;0;0;0;3;3
191;1;12;0;0;0;2;2
191;1;13;1;0;1;5;6
191;1;14;3;0;0;9;12
191;1;15;2;0;0;7;9
191;1;16;1;0;1;16;17
191;1;17;3;0;3;5;8
191;1;18;4;0;0;8;12
191;1;19;1;0;0;2;3
191;1;20;1;0;0;4;5
192;1;1;0;0;0;0;0
192;1;2;0;0;0;0;0
192;1;3;0;1;0;11;11
192;1;4;1;0;0;12;13
192;1;5;2;0;0;9;11
192;1;6;2;1;0;8;10
192;1;7;0;0;0;4;4
192;1;8;0;0;0;0;0
192;1;9;0;0;0;0;0
192;1;10;0;0;0;0;0
192;1;11;0;0;0;1;1
192;1;12;0;1;0;5;5
192;1;13;3;2;0;10;13
192;1;14;4;5;0;6;10
192;1;15;1;1;0;4;5
192;1;16;0;0;0;0;0
192;1;17;0;0;0;0;0
192;1;18;0;0;0;0;0
192;1;19;0;0;0;0;0
192;1;20;0;0;0;0;0
194;1;1;0;0;0;0;0
194;1;2;0;0;0;1;1
194;1;3;2;0;0;12;14
194;1;4;2;0;0;19;21
194;1;5;2;0;0;20;22
194;1;6;0;0;0;18;18
194;1;7;0;0;0;11;11
194;1;8;1;0;0;11;12
194;1;9;1;0;0;9;10
194;1;10;4;0;0;10;14
194;1;11;1;0;0;9;10
194;1;12;0;0;0;4;4
194;1;13;0;0;0;2;2
194;1;14;0;0;0;10;10
194;1;15;0;0;0;18;18
194;1;16;1;0;0;28;29
194;1;17;0;0;0;14;14
194;1;18;0;0;0;14;14
194;1;19;0;0;0;3;3
194;1;20;0;0;0;5;5
195;1;1;0;0;0;0;0
195;1;2;0;0;0;0;0
195;1;3;4;6;0;12;16
195;1;4;2;3;0;7;9
195;1;5;2;2;0;7;9
195;1;6;1;2;0;5;6
195;1;7;2;1;0;3;5
195;1;8;1;1;0;1;2
195;1;9;3;1;0;1;4
195;1;10;2;2;0;9;11
195;1;11;1;1;0;6;7
195;1;12;3;1;0;2;5
195;1;13;3;2;0;4;7
195;1;14;3;0;0;2;5
195;1;15;0;1;0;2;2
195;1;16;2;0;0;1;3
195;1;17;0;0;0;2;2
195;1;18;0;0;0;1;1
195;1;19;0;0;0;0;0
195;1;20;0;0;0;0;0
196;1;1;0;0;0;0;0
196;1;2;0;0;0;0;0
196;1;3;0;0;0;0;0
196;1;4;0;0;0;0;0
196;1;5;0;0;0;3;3
196;1;6;0;0;0;7;7
196;1;7;0;0;0;6;6
196;1;8;0;0;0;7;7
196;1;9;0;0;0;7;7
196;1;10;0;0;0;1;1
196;1;11;0;0;0;1;1
196;1;12;0;0;0;0;0
196;1;13;0;0;0;0;0
196;1;14;0;0;0;0;0
196;1;15;0;0;0;0;0
196;1;16;0;0;0;0;0
196;1;17;0;0;0;0;0
196;1;18;0;0;0;2;2
196;1;19;0;0;0;3;3
196;1;20;0;0;0;1;1
196;1;21;0;0;0;4;4
196;1;22;0;0;0;4;4
196;1;23;0;0;0;2;2
196;1;24;0;0;0;3;3
196;1;25;0;0;0;1;1
196;1;26;0;0;0;1;1
196;1;27;0;0;0;1;1
196;1;28;0;0;0;0;0
196;1;29;0;0;0;0;0
196;1;30;0;0;0;0;0
196;1;31;0;0;0;0;0
196;1;32;0;0;0;0;0
196;1;33;0;0;0;0;0
196;1;34;0;0;0;0;0
196;1;35;0;0;0;0;0
196;1;36;0;0;0;0;0
196;1;37;0;0;0;0;0
196;1;38;0;0;0;0;0
196;1;39;0;0;0;0;0
196;1;40;0;0;0;0;0
197;1;1;0;0;0;0;0
197;1;2;0;1;0;1;1
197;1;3;4;3;0;6;10
197;1;4;5;0;0;5;10
197;1;5;4;1;0;1;5
197;1;6;3;0;0;3;6
197;1;7;2;0;0;0;2
197;1;8;0;0;0;0;0
197;1;9;0;0;0;0;0
197;1;10;0;0;0;0;0
197;1;11;4;4;0;1;5
197;1;12;11;7;0;6;17
197;1;13;7;3;0;4;11
197;1;14;4;0;0;2;6
197;1;15;2;0;0;1;3
197;1;16;0;0;0;0;0
197;1;17;0;0;0;0;0
197;1;18;0;0;0;0;0
197;1;19;0;0;0;0;0
197;1;20;0;0;0;0;0
198;1;1;0;0;0;0;0
198;1;2;0;0;0;1;1
198;1;3;0;0;0;6;6
198;1;4;0;0;0;10;10
198;1;5;0;0;0;11;11
198;1;6;1;0;0;14;15
198;1;7;0;0;0;6;6
198;1;8;0;0;0;4;4
198;1;9;0;0;0;4;4
198;1;10;0;0;0;3;3
198;1;11;0;0;0;2;2
198;1;12;0;0;0;5;5
198;1;13;0;0;0;5;5
198;1;14;0;0;0;10;10
198;1;15;0;0;0;6;6
198;1;16;0;0;0;2;2
198;1;17;0;0;0;3;3
198;1;18;0;0;0;1;1
198;1;19;0;0;0;0;0
198;1;20;0;0;0;0;0
199;1;1;0;0;0;2;2
199;1;2;0;0;0;10;10
199;1;3;0;0;0;6;6
199;1;4;0;0;0;15;15
199;1;5;0;0;0;12;12
199;1;6;0;0;0;8;8
199;1;7;0;0;0;4;4
199;1;8;0;0;0;6;6
199;1;9;0;0;0;4;4
199;1;10;0;0;0;3;3
199;1;11;0;0;0;5;5
199;1;12;0;0;0;3;3
199;1;13;0;0;0;18;18
199;1;14;0;0;0;9;9
199;1;15;0;0;0;4;4
199;1;16;0;0;0;2;2
199;1;17;0;0;0;1;1
199;1;18;0;0;0;0;0
199;1;19;0;0;0;0;0
199;1;20;0;0;0;0;0
200;1;1;0;0;0;0;0
200;1;2;0;0;0;1;1
200;1;3;0;0;0;6;6
200;1;4;0;0;0;13;13
200;1;5;0;0;0;11;11
200;1;6;0;0;0;10;10
200;1;7;0;0;0;6;6
200;1;8;0;0;0;6;6
200;1;9;0;0;0;4;4
200;1;10;0;0;0;2;2
200;1;11;0;0;0;4;4
200;1;12;0;0;0;4;4
200;1;13;0;0;0;4;4
200;1;14;0;0;0;14;14
200;1;15;0;0;0;11;11
200;1;16;0;0;0;4;4
200;1;17;0;0;0;6;6
200;1;18;0;0;0;3;3
200;1;19;0;0;0;1;1
200;1;20;0;0;0;0;0
201;1;1;0;0;0;0;0
201;1;2;0;0;0;0;0
201;1;3;2;1;0;6;8
201;1;4;0;1;0;6;6
201;1;5;2;0;0;8;10
201;1;6;0;0;0;3;3
201;1;7;0;0;0;1;1
201;1;8;0;0;0;0;0
201;1;9;0;0;0;0;0
201;1;10;0;0;0;0;0
201;1;11;0;0;0;5;5
201;1;12;0;0;0;6;6
201;1;13;0;0;0;7;7
201;1;14;0;0;0;4;4
201;1;15;0;0;0;0;0
201;1;16;0;0;0;0;0
201;1;17;0;0;0;0;0
201;1;18;0;0;0;0;0
201;1;19;0;0;0;0;0
201;1;20;0;0;0;0;0
202;1;1;0;0;0;0;0
202;1;2;1;0;0;1;2
202;1;3;5;3;0;11;16
202;1;4;4;0;0;21;25
202;1;5;4;1;0;24;28
202;1;6;2;1;0;22;24
202;1;7;4;1;0;30;34
202;1;8;1;0;0;21;22
202;1;9;1;0;0;12;13
202;1;10;0;0;0;16;16
202;1;11;1;0;0;11;12
202;1;12;0;0;0;9;9
202;1;13;0;0;0;10;10
202;1;14;0;0;0;20;20
202;1;15;0;0;0;5;5
202;1;16;0;0;0;9;9
202;1;17;1;1;0;19;20
202;1;18;0;0;0;11;11
202;1;19;0;0;0;0;0
202;1;20;0;0;0;0;0
204;1;1;0;0;0;1;1
204;1;2;0;0;0;6;6
204;1;3;0;0;0;20;20
204;1;4;0;0;0;25;25
204;1;5;0;0;0;21;21
204;1;6;0;0;0;18;18
204;1;7;1;0;0;23;24
204;1;8;0;0;0;11;11
204;1;9;0;0;0;8;8
204;1;10;0;0;0;6;6
204;1;11;0;0;0;11;11
204;1;12;0;0;0;10;10
204;1;13;0;0;0;5;5
204;1;14;0;0;0;19;19
204;1;15;0;0;0;16;16
204;1;16;0;0;0;9;9
204;1;17;0;0;0;9;9
204;1;18;0;0;0;3;3
204;1;19;0;0;0;1;1
204;1;20;0;0;0;0;0
205;1;1;0;0;0;0;0
205;1;2;3;2;0;3;6
205;1;3;2;2;0;11;13
205;1;4;3;2;0;7;10
205;1;5;3;0;0;9;12
205;1;6;4;2;0;5;9
205;1;7;4;3;0;3;7
205;1;8;2;3;0;5;7
205;1;9;2;2;0;4;6
205;1;10;2;0;0;2;4
205;1;11;0;0;0;0;0
205;1;12;2;1;0;2;4
205;1;13;5;4;0;5;10
205;1;14;3;4;0;9;12
205;1;15;0;0;0;3;3
205;1;16;0;0;0;1;1
205;1;17;0;0;0;1;1
205;1;18;0;0;0;3;3
205;1;19;0;0;0;0;0
205;1;20;0;0;0;0;0
207;1;1;0;0;0;0;0
207;1;2;0;0;0;5;5
207;1;3;0;0;0;8;8
207;1;4;0;0;0;5;5
207;1;5;0;0;0;6;6
207;1;6;0;0;0;4;4
207;1;7;0;0;0;4;4
207;1;8;0;0;0;1;1
207;1;9;0;0;0;1;1
207;1;10;0;0;0;3;3
207;1;11;1;1;0;4;5
207;1;12;3;0;0;10;13
207;1;13;0;0;0;4;4
207;1;14;0;0;0;6;6
207;1;15;0;0;0;5;5
207;1;16;0;0;0;8;8
207;1;17;0;0;0;2;2
207;1;18;0;0;0;0;0
207;1;19;0;0;0;0;0
207;1;20;0;0;0;0;0
209;1;1;0;0;0;0;0
209;1;2;4;2;0;1;5
209;1;3;8;2;0;3;11
209;1;4;6;2;0;6;12
209;1;5;5;2;0;5;10
209;1;6;4;1;0;3;7
209;1;7;3;0;0;3;6
209;1;8;5;0;0;1;6
209;1;9;3;1;0;2;5
209;1;10;0;1;0;2;2
209;1;11;0;0;0;1;1
209;1;12;4;1;0;2;6
209;1;13;2;0;0;3;5
209;1;14;1;2;0;2;3
209;1;15;1;1;0;4;5
209;1;16;2;1;0;1;3
209;1;17;2;0;0;1;3
209;1;18;0;0;0;0;0
209;1;19;0;0;0;0;0
209;1;20;0;0;0;0;0
211;1;1;0;0;0;0;0
211;1;2;0;0;0;1;1
211;1;3;0;0;0;10;10
211;1;4;0;0;0;21;21
211;1;5;0;0;0;12;12
211;1;6;0;0;0;9;9
211;1;7;0;0;0;1;1
211;1;8;0;0;0;0;0
211;1;9;0;0;0;0;0
211;1;10;0;0;0;0;0
211;1;11;0;0;0;2;2
211;1;12;0;0;0;8;8
211;1;13;0;0;0;19;19
211;1;14;0;0;0;19;19
211;1;15;0;0;0;17;17
211;1;16;0;0;0;9;9
211;1;17;0;0;0;4;4
211;1;18;0;0;0;0;0
211;1;19;0;0;0;0;0
211;1;20;0;0;0;0;0
212;1;1;0;0;0;0;0
212;1;2;1;0;0;7;8
212;1;3;1;0;0;8;9
212;1;4;3;0;0;7;10
212;1;5;3;0;0;11;14
212;1;6;2;0;0;8;10
212;1;7;2;0;0;11;13
212;1;8;1;0;0;9;10
212;1;9;0;0;0;0;0
212;1;10;0;0;0;1;1
212;1;11;0;0;0;1;1
212;1;12;0;0;0;2;2
212;1;13;2;0;0;2;4
212;1;14;1;1;0;11;12
212;1;15;0;0;0;9;9
212;1;16;0;0;0;8;8
212;1;17;0;0;0;4;4
212;1;18;0;0;0;1;1
212;1;19;0;0;0;2;2
212;1;20;0;0;0;1;1
213;1;1;0;0;0;0;0
213;1;2;0;0;0;2;2
213;1;3;10;5;0;9;19
213;1;4;6;2;0;12;18
213;1;5;4;3;0;6;10
213;1;6;3;0;0;3;6
213;1;7;2;0;0;3;5
213;1;8;1;0;0;3;4
213;1;9;2;0;0;1;3
213;1;10;1;0;0;3;4
213;1;11;1;2;0;5;6
213;1;12;4;2;0;8;12
213;1;13;4;2;0;6;10
213;1;14;3;2;0;7;10
213;1;15;7;5;0;8;15
213;1;16;4;2;0;4;8
213;1;17;3;1;0;2;5
213;1;18;0;0;0;0;0
213;1;19;0;0;0;0;0
213;1;20;0;0;0;0;0
214;1;1;0;0;0;0;0
214;1;2;0;0;0;4;4
214;1;3;0;0;0;23;23
214;1;4;0;0;0;29;29
214;1;5;0;0;0;19;19
214;1;6;0;0;0;13;13
214;1;7;0;0;0;9;9
214;1;8;0;0;0;1;1
214;1;9;0;0;0;1;1
214;1;10;0;0;0;5;5
214;1;11;0;0;0;4;4
214;1;12;0;0;0;6;6
214;1;13;0;0;0;6;6
214;1;14;0;0;0;6;6
214;1;15;0;0;0;1;1
214;1;16;0;0;0;0;0
214;1;17;0;0;0;0;0
214;1;18;0;0;0;0;0
214;1;19;0;0;0;0;0
214;1;20;0;0;0;0;0
216;1;1;0;0;0;0;0
216;1;2;2;1;0;0;2
216;1;3;10;3;0;5;15
216;1;4;3;0;0;6;9
216;1;5;1;0;0;6;7
216;1;6;3;1;0;1;4
216;1;7;2;2;0;0;2
216;1;8;3;2;0;1;4
216;1;9;0;0;0;0;0
216;1;10;1;1;0;0;1
216;1;11;0;0;0;1;1
216;1;12;1;1;0;0;1
216;1;13;0;0;0;2;2
216;1;14;3;1;0;2;5
216;1;15;5;0;0;0;5
216;1;16;2;1;0;2;4
216;1;17;1;0;0;2;3
216;1;18;1;0;0;0;1
216;1;19;0;0;0;0;0
216;1;20;0;0;0;0;0
217;1;1;0;0;0;0;0
217;1;2;0;0;0;0;0
217;1;3;0;0;0;7;7
217;1;4;0;0;0;9;9
217;1;5;0;0;0;5;5
217;1;6;0;0;0;5;5
217;1;7;0;0;0;1;1
217;1;8;0;0;0;0;0
217;1;9;0;0;0;0;0
217;1;10;0;0;0;1;1
217;1;11;0;0;0;3;3
217;1;12;0;0;0;6;6
217;1;13;0;0;0;7;7
217;1;14;0;0;0;8;8
217;1;15;0;0;0;11;11
217;1;16;0;0;0;3;3
217;1;17;0;0;0;0;0
217;1;18;0;0;0;0;0
217;1;19;0;0;0;0;0
217;1;20;0;0;0;0;0
218;1;1;0;0;0;0;0
218;1;2;0;0;0;3;3
218;1;3;1;1;0;11;12
218;1;4;1;0;0;9;10
218;1;5;0;0;0;7;7
218;1;6;0;0;0;3;3
218;1;7;0;0;0;3;3
218;1;8;0;0;0;1;1
218;1;9;0;0;0;1;1
218;1;10;1;0;0;9;10
218;1;11;2;3;0;5;7
218;1;12;3;2;0;2;5
218;1;13;0;0;0;4;4
218;1;14;0;0;0;0;0
218;1;15;0;0;0;0;0
218;1;16;0;0;0;0;0
218;1;17;0;0;0;0;0
218;1;18;0;0;0;0;0
218;1;19;0;0;0;0;0
218;1;20;0;0;0;0;0
220;1;1;0;0;0;0;0
220;1;2;0;0;0;0;0
220;1;3;0;0;0;1;1
220;1;4;1;2;0;5;6
220;1;5;2;1;0;4;6
220;1;6;3;3;0;6;9
220;1;7;2;3;0;10;12
220;1;8;5;3;0;8;13
220;1;9;3;2;1;4;7
220;1;10;2;3;0;2;4
220;1;11;3;2;0;1;4
220;1;12;2;1;0;0;2
220;1;13;1;1;0;0;1
220;1;14;0;0;0;0;0
220;1;15;0;0;0;0;0
220;1;16;0;0;0;0;0
220;1;17;0;0;0;0;0
220;1;18;0;0;0;0;0
220;1;19;0;0;0;0;0
220;1;20;1;1;0;0;1
220;1;21;0;0;0;4;4
220;1;22;0;1;0;4;4
220;1;23;1;0;0;5;6
220;1;24;0;0;0;3;3
220;1;25;0;0;0;4;4
220;1;26;0;0;0;5;5
220;1;27;0;0;0;1;1
220;1;28;0;0;0;2;2
220;1;29;0;0;0;1;1
220;1;30;0;0;0;0;0
220;1;31;0;0;0;0;0
220;1;32;0;0;0;0;0
220;1;33;0;0;0;0;0
220;1;34;0;0;0;0;0
220;1;35;0;0;0;0;0
220;1;36;0;0;0;0;0
220;1;37;0;0;0;0;0
220;1;38;0;0;0;0;0
220;1;39;0;0;0;0;0
220;1;40;0;0;0;0;0
223;1;1;0;0;0;0;0
223;1;2;0;0;0;4;4
223;1;3;0;0;0;8;8
223;1;4;1;1;0;16;17
223;1;5;0;0;0;19;19
223;1;6;0;0;0;10;10
223;1;7;0;0;0;6;6
223;1;8;0;0;0;4;4
223;1;9;0;0;0;3;3
223;1;10;0;0;0;0;0
223;1;11;0;0;0;0;0
223;1;12;0;0;0;6;6
223;1;13;1;0;0;7;8
223;1;14;2;0;0;7;9
223;1;15;0;0;0;9;9
223;1;16;0;0;0;5;5
223;1;17;1;0;0;2;3
223;1;18;0;0;0;1;1
223;1;19;0;0;0;0;0
223;1;20;0;0;0;0;0
229;1;1;0;0;0;0;0
229;1;2;0;0;0;15;15
229;1;3;0;0;0;13;13
229;1;4;1;0;0;17;18
229;1;5;0;0;0;20;20
229;1;6;1;0;0;21;22
229;1;7;0;0;0;16;16
229;1;8;1;0;0;10;11
229;1;9;0;0;0;12;12
229;1;10;0;0;0;6;6
229;1;11;0;0;0;1;1
229;1;12;0;0;0;2;2
229;1;13;0;0;0;9;9
229;1;14;0;0;0;16;16
229;1;15;0;0;0;11;11
229;1;16;0;0;0;5;5
229;1;17;0;0;0;5;5
229;1;18;0;0;0;0;0
229;1;19;0;0;0;0;0
229;1;20;0;0;0;0;0
230;1;1;0;0;0;0;0
230;1;2;0;0;0;0;0
230;1;3;7;1;1;4;11
230;1;4;5;2;2;6;11
230;1;5;5;0;1;3;8
230;1;6;2;0;0;1;3
230;1;7;1;0;0;1;2
230;1;8;1;0;0;0;1
230;1;9;0;0;0;0;0
230;1;10;1;0;0;1;2
230;1;11;3;0;0;6;9
230;1;12;5;0;0;6;11
230;1;13;3;0;1;5;8
230;1;14;2;0;0;4;6
230;1;15;2;0;0;3;5
230;1;16;0;0;0;0;0
230;1;17;0;0;0;0;0
230;1;18;0;0;0;0;0
230;1;19;0;0;0;0;0
230;1;20;0;0;0;0;0
231;1;1;0;0;0;4;4
231;1;2;0;0;0;10;10
231;1;3;0;0;0;13;13
231;1;4;0;0;0;10;10
231;1;5;2;0;0;8;10
231;1;6;0;0;0;7;7
231;1;7;0;0;0;7;7
231;1;8;0;0;0;9;9
231;1;9;0;0;0;5;5
231;1;10;0;0;0;7;7
231;1;11;0;0;0;13;13
231;1;12;0;0;0;13;13
231;1;13;0;0;0;13;13
231;1;14;2;0;0;13;15
231;1;15;0;0;0;10;10
231;1;16;0;0;0;7;7
231;1;17;0;0;0;3;3
231;1;18;0;0;0;8;8
231;1;19;0;0;0;9;9
231;1;20;0;0;0;5;5
232;1;1;0;0;0;0;0
232;1;2;0;0;0;4;4
232;1;3;1;0;0;9;10
232;1;4;1;0;0;15;16
232;1;5;0;0;0;15;15
232;1;6;0;0;0;12;12
232;1;7;1;0;0;12;13
232;1;8;0;0;0;8;8
232;1;9;0;0;0;7;7
232;1;10;0;0;0;1;1
232;1;11;2;1;0;2;4
232;1;12;1;2;0;9;10
232;1;13;3;0;0;7;10
232;1;14;4;2;0;9;13
232;1;15;3;0;0;7;10
232;1;16;1;1;0;4;5
232;1;17;1;2;0;3;4
232;1;18;1;2;0;1;2
232;1;19;0;0;0;1;1
232;1;20;2;1;0;1;3
233;1;1;0;0;0;0;0
233;1;2;3;0;0;0;3
233;1;3;6;4;0;2;8
233;1;4;5;2;0;5;10
233;1;5;3;3;0;2;5
233;1;6;3;2;0;3;6
233;1;7;2;0;0;1;3
233;1;8;1;1;0;3;4
233;1;9;3;2;0;1;4
233;1;10;4;1;0;2;6
233;1;11;2;1;0;2;4
233;1;12;1;0;0;2;3
233;1;13;7;6;0;7;14
233;1;14;5;6;0;5;10
233;1;15;0;1;0;3;3
233;1;16;1;0;0;1;2
233;1;17;0;0;0;0;0
233;1;18;0;0;0;0;0
233;1;19;0;0;0;0;0
233;1;20;0;0;0;0;0
236;1;1;0;0;0;0;0
236;1;2;6;4;0;5;11
236;1;3;3;0;0;8;11
236;1;4;6;1;1;8;14
236;1;5;1;0;0;8;9
236;1;6;1;1;0;4;5
236;1;7;0;0;0;4;4
236;1;8;0;0;0;0;0
236;1;9;0;0;0;0;0
236;1;10;0;0;0;0;0
236;1;11;0;0;0;0;0
236;1;12;4;1;0;5;9
236;1;13;7;1;0;8;15
236;1;14;2;1;0;6;8
236;1;15;1;0;0;2;3
236;1;16;4;0;0;4;8
236;1;17;0;0;0;0;0
236;1;18;0;0;0;0;0
236;1;19;0;0;0;0;0
236;1;20;0;0;0;0;0
237;1;1;0;0;0;1;1
237;1;2;0;0;0;5;5
237;1;3;0;0;0;15;15
237;1;4;0;0;0;22;22
237;1;5;0;0;0;12;12
237;1;6;0;0;0;14;14
237;1;7;0;0;0;8;8
237;1;8;0;0;0;7;7
237;1;9;0;0;0;4;4
237;1;10;0;0;0;3;3
237;1;11;0;0;0;3;3
237;1;12;0;0;0;13;13
237;1;13;0;0;0;8;8
237;1;14;0;0;0;5;5
237;1;15;0;0;0;5;5
237;1;16;0;0;0;8;8
237;1;17;0;0;0;5;5
237;1;18;0;0;0;5;5
237;1;19;0;0;0;0;0
237;1;20;0;0;0;0;0
238;1;1;0;0;0;0;0
238;1;2;0;0;0;4;4
238;1;3;0;0;0;10;10
238;1;4;0;0;0;12;12
238;1;5;0;0;0;9;9
238;1;6;0;0;0;4;4
238;1;7;0;0;0;1;1
238;1;8;0;0;0;2;2
238;1;9;0;0;0;5;5
238;1;10;0;0;0;3;3
238;1;11;0;0;0;3;3
238;1;12;0;0;0;8;8
238;1;13;0;0;0;12;12
238;1;14;0;0;0;7;7
238;1;15;0;0;0;5;5
238;1;16;0;0;0;6;6
238;1;17;0;0;0;7;7
238;1;18;0;0;0;1;1
238;1;19;0;0;0;0;0
238;1;20;0;0;0;0;0
239;1;1;0;0;0;0;0
239;1;2;0;1;0;12;12
239;1;3;0;0;0;11;11
239;1;4;1;0;0;10;11
239;1;5;0;0;0;10;10
239;1;6;0;0;0;6;6
239;1;7;0;0;0;1;1
239;1;8;0;0;0;0;0
239;1;9;0;0;0;0;0
239;1;10;0;0;0;0;0
239;1;11;1;0;0;1;2
239;1;12;3;1;1;4;7
239;1;13;0;0;0;5;5
239;1;14;0;0;0;1;1
239;1;15;0;0;0;0;0
239;1;16;0;0;0;0;0
239;1;17;0;0;0;0;0
239;1;18;0;0;0;0;0
239;1;19;0;0;0;0;0
239;1;20;0;0;0;0;0
240;1;1;0;0;0;0;0
240;1;2;0;0;0;0;0
240;1;3;0;0;0;1;1
240;1;4;0;0;0;3;3
240;1;5;1;1;0;4;5
240;1;6;3;3;0;4;7
240;1;7;3;1;0;5;8
240;1;8;3;1;0;4;7
240;1;9;4;4;0;5;9
240;1;10;3;0;0;5;8
240;1;11;2;0;0;3;5
240;1;12;1;0;0;1;2
240;1;13;0;0;0;2;2
240;1;14;0;0;0;1;1
240;1;15;1;0;0;0;1
240;1;16;1;1;0;0;1
240;1;17;1;0;0;0;1
240;1;18;1;1;0;0;1
240;1;19;0;0;0;2;2
240;1;20;0;0;0;2;2
240;1;21;0;0;0;1;1
240;1;22;0;0;0;1;1
240;1;23;0;0;0;0;0
240;1;24;0;0;0;2;2
240;1;25;2;3;0;3;5
240;1;26;2;1;0;2;4
240;1;27;0;0;0;1;1
240;1;28;0;0;0;2;2
240;1;29;0;0;0;1;1
240;1;30;0;0;0;0;0
240;1;31;0;0;0;0;0
240;1;32;0;0;0;0;0
240;1;33;0;0;0;0;0
240;1;34;0;0;0;0;0
240;1;35;0;0;0;0;0
240;1;36;0;0;0;0;0
240;1;37;0;0;0;0;0
240;1;38;0;0;0;0;0
240;1;39;0;0;0;0;0
240;1;40;0;0;0;0;0
242;1;1;0;0;0;0;0
242;1;2;0;0;0;1;1
242;1;3;4;2;0;4;8
242;1;4;5;2;0;11;16
242;1;5;3;0;0;12;15
242;1;6;5;1;0;7;12
242;1;7;2;1;0;7;9
242;1;8;2;2;0;5;7
242;1;9;0;0;0;0;0
242;1;10;3;3;0;1;4
242;1;11;6;2;0;5;11
242;1;12;3;1;0;3;6
242;1;13;8;6;0;10;18
242;1;14;5;3;0;8;13
242;1;15;11;7;0;14;25
242;1;16;10;5;0;10;20
242;1;17;6;5;0;12;18
242;1;18;6;3;0;4;10
242;1;19;4;2;0;2;6
242;1;20;0;0;0;0;0
271;1;1;0;0;0;0;0
271;1;2;0;0;0;0;0
271;1;3;0;0;0;10;10
271;1;4;0;0;0;13;13
271;1;5;0;0;0;10;10
271;1;6;0;0;0;8;8
271;1;7;0;0;0;7;7
271;1;8;0;0;0;3;3
271;1;9;0;0;0;0;0
271;1;10;0;0;0;0;0
271;1;11;0;0;0;2;2
271;1;12;0;0;0;8;8
271;1;13;0;0;0;15;15
271;1;14;0;0;0;16;16
271;1;15;0;0;0;6;6
271;1;16;0;0;0;6;6
271;1;17;0;0;0;3;3
271;1;18;0;0;0;2;2
271;1;19;0;0;0;0;0
271;1;20;0;0;0;0;0
97;1;1;0;0;0;0;0
97;1;2;0;0;0;0;0
97;1;3;0;0;0;1;1
97;1;4;0;0;0;6;6
97;1;5;0;0;0;6;6
97;1;6;0;0;0;5;5
97;1;7;1;0;0;6;7
97;1;8;0;0;0;9;9
97;1;9;0;0;0;7;7
97;1;10;0;0;0;6;6
97;1;11;0;0;0;9;9
97;1;12;0;0;0;8;8
97;1;13;0;0;0;6;6
97;1;14;0;0;0;6;6
97;1;15;0;0;0;3;3
97;1;16;0;0;0;3;3
97;1;17;0;0;0;3;3
97;1;18;0;0;0;2;2
97;1;19;0;0;0;2;2
97;1;20;0;0;0;0;0
120;1;1;0;0;0;0;0
120;1;2;0;0;0;0;0
120;1;3;2;0;0;0;2
120;1;4;1;0;0;1;2
120;1;5;1;0;0;1;2
120;1;6;1;0;0;1;2
120;1;7;0;0;0;3;3
120;1;8;0;0;0;3;3
120;1;9;0;0;0;3;3
120;1;10;0;0;0;4;4
120;1;11;0;0;0;4;4
120;1;12;0;0;0;2;2
120;1;13;0;0;0;1;1
120;1;14;0;0;0;1;1
120;1;15;0;0;0;1;1
120;1;16;0;0;0;2;2
120;1;17;0;0;0;2;2
120;1;18;0;0;0;1;1
120;1;19;0;0;0;1;1
120;1;20;0;0;0;1;1
128;1;1;0;0;0;0;0
128;1;2;0;1;0;1;1
128;1;3;0;0;0;2;2
128;1;4;0;0;0;2;2
128;1;5;0;0;0;4;4
128;1;6;1;0;0;6;7
128;1;7;0;0;0;6;6
128;1;8;0;0;0;6;6
128;1;9;2;0;0;7;9
128;1;10;0;0;0;6;6
128;1;11;2;0;0;6;8
128;1;12;2;0;0;5;7
128;1;13;0;0;0;6;6
128;1;14;1;0;0;5;6
128;1;15;0;0;0;6;6
128;1;16;1;0;0;4;5
128;1;17;1;0;0;2;3
128;1;18;0;0;0;3;3
128;1;19;0;0;0;3;3
128;1;20;0;0;0;2;2
132;1;1;0;0;0;0;0
132;1;2;1;1;0;1;2
132;1;3;0;0;0;2;2
132;1;4;0;1;0;3;3
132;1;5;1;1;0;6;7
132;1;6;2;2;0;5;7
132;1;7;0;0;0;9;9
132;1;8;2;1;0;7;9
132;1;9;1;1;0;9;10
132;1;10;5;3;0;10;15
132;1;11;6;5;0;6;12
132;1;12;5;2;0;10;15
132;1;13;3;1;0;9;12
132;1;14;5;3;0;9;14
132;1;15;6;4;0;6;12
132;1;16;3;2;0;8;11
132;1;17;4;2;0;7;11
132;1;18;2;1;0;6;8
132;1;19;3;0;0;4;7
132;1;20;2;0;0;6;8
133;1;1;0;1;0;1;1
133;1;2;0;2;0;2;2
133;1;3;5;6;0;4;9
133;1;4;3;3;0;5;8
133;1;5;7;6;0;2;9
133;1;6;7;6;0;3;10
133;1;7;4;6;0;7;11
133;1;8;8;6;0;3;11
133;1;9;6;4;0;2;8
133;1;10;5;3;0;4;9
133;1;11;5;3;0;2;7
133;1;12;6;4;0;2;8
133;1;13;4;1;0;2;6
133;1;14;4;2;0;1;5
133;1;15;3;1;0;1;4
133;1;16;4;2;0;0;4
133;1;17;2;1;0;2;4
133;1;18;2;1;0;2;4
133;1;19;1;2;0;2;3
133;1;20;2;1;0;1;3
140;1;1;0;0;0;0;0
140;1;2;0;0;0;1;1
140;1;3;0;0;0;1;1
140;1;4;0;0;0;3;3
140;1;5;0;0;0;5;5
140;1;6;0;0;0;5;5
140;1;7;0;0;0;5;5
140;1;8;0;0;0;5;5
140;1;9;0;0;0;5;5
140;1;10;0;0;0;5;5
140;1;11;0;0;0;3;3
140;1;12;0;0;0;3;3
140;1;13;0;0;0;3;3
140;1;14;0;0;0;4;4
140;1;15;0;0;0;4;4
140;1;16;0;0;0;2;2
140;1;17;0;0;0;2;2
140;1;18;0;0;0;2;2
140;1;19;0;0;0;1;1
140;1;20;0;0;0;1;1
146;1;1;0;0;0;0;0
146;1;2;0;0;0;2;2
146;1;3;6;1;0;5;11
146;1;4;9;1;0;10;19
146;1;5;8;0;1;15;23
146;1;6;7;1;0;10;17
146;1;7;5;2;0;10;15
146;1;8;4;1;0;12;16
146;1;9;7;2;0;8;15
146;1;10;4;0;0;10;14
146;1;11;2;0;0;10;12
146;1;12;0;0;0;7;7
146;1;13;4;0;1;1;5
146;1;14;1;2;0;4;5
146;1;15;0;0;0;5;5
146;1;16;0;0;0;4;4
146;1;17;0;0;0;2;2
146;1;18;0;0;0;1;1
146;1;19;0;0;0;1;1
146;1;20;0;0;0;1;1
149;1;1;0;0;0;1;1
149;1;2;0;0;0;2;2
149;1;3;0;0;0;2;2
149;1;4;0;0;0;8;8
149;1;5;0;0;0;8;8
149;1;6;0;0;0;10;10
149;1;7;1;1;0;11;12
149;1;8;1;0;0;9;10
149;1;9;0;0;0;12;12
149;1;10;1;0;0;10;11
149;1;11;0;0;0;10;10
149;1;12;0;0;0;8;8
149;1;13;0;0;0;7;7
149;1;14;0;0;0;10;10
149;1;15;1;0;0;8;9
149;1;16;1;0;0;7;8
149;1;17;1;0;0;11;12
149;1;18;0;0;0;5;5
149;1;19;1;0;0;3;4
149;1;20;1;1;0;5;6
151;1;1;0;0;0;1;1
151;1;2;0;0;0;2;2
151;1;3;0;0;0;7;7
151;1;4;0;0;0;10;10
151;1;5;0;0;0;10;10
151;1;6;0;0;0;8;8
151;1;7;0;0;0;11;11
151;1;8;0;0;0;11;11
151;1;9;0;0;0;12;12
151;1;10;0;0;0;13;13
151;1;11;0;0;0;18;18
151;1;12;0;0;0;20;20
151;1;13;0;0;0;12;12
151;1;14;0;0;0;10;10
151;1;15;0;0;0;10;10
151;1;16;0;0;0;14;14
151;1;17;1;0;0;10;11
151;1;18;0;0;0;8;8
151;1;19;0;0;0;11;11
151;1;20;0;0;0;9;9
152;1;1;0;0;0;1;1
152;1;2;0;0;0;1;1
152;1;3;0;0;0;2;2
152;1;4;0;0;0;1;1
152;1;5;0;0;0;1;1
152;1;6;0;0;0;1;1
152;1;7;0;0;0;1;1
152;1;8;0;0;0;3;3
152;1;9;0;0;0;4;4
152;1;10;0;0;0;4;4
152;1;11;0;0;0;6;6
152;1;12;0;0;0;8;8
152;1;13;0;0;0;2;2
152;1;14;0;0;0;2;2
152;1;15;0;0;0;2;2
152;1;16;0;0;0;3;3
152;1;17;0;0;0;2;2
152;1;18;0;0;0;0;0
152;1;19;0;0;0;0;0
152;1;20;0;0;0;0;0
162;1;1;0;0;0;0;0
162;1;2;0;0;0;1;1
162;1;3;0;0;0;2;2
162;1;4;0;0;0;2;2
162;1;5;0;0;0;3;3
162;1;6;0;0;0;4;4
162;1;7;0;1;0;4;4
162;1;8;0;1;0;5;5
162;1;9;0;0;0;6;6
162;1;10;0;0;0;7;7
162;1;11;0;0;0;8;8
162;1;12;0;0;0;8;8
162;1;13;0;1;0;7;7
162;1;14;0;0;0;8;8
162;1;15;0;1;0;7;7
162;1;16;0;0;0;7;7
162;1;17;0;1;0;6;6
162;1;18;0;0;0;5;5
162;1;19;0;1;0;5;5
162;1;20;0;0;0;1;1
206;1;1;0;0;0;0;0
206;1;2;0;0;0;0;0
206;1;3;0;0;0;3;3
206;1;4;1;0;0;3;4
206;1;5;0;0;0;3;3
206;1;6;0;0;0;4;4
206;1;7;0;0;0;5;5
206;1;8;0;0;0;5;5
206;1;9;0;0;0;7;7
206;1;10;0;0;0;6;6
206;1;11;0;0;0;7;7
206;1;12;0;0;0;7;7
206;1;13;0;0;0;6;6
206;1;14;0;0;0;7;7
206;1;15;0;0;0;6;6
206;1;16;0;0;0;4;4
206;1;17;0;0;0;5;5
206;1;18;0;0;0;5;5
206;1;19;0;0;0;5;5
206;1;20;0;0;0;4;4
215;1;1;0;0;0;0;0
215;1;2;0;0;0;1;1
215;1;3;0;1;0;4;4
215;1;4;0;0;0;5;5
215;1;5;0;0;0;3;3
215;1;6;0;0;0;3;3
215;1;7;0;0;0;2;2
215;1;8;0;0;0;3;3
215;1;9;0;0;0;3;3
215;1;10;0;0;0;3;3
215;1;11;0;0;0;3;3
215;1;12;0;0;0;3;3
215;1;13;0;0;0;2;2
215;1;14;0;0;0;2;2
215;1;15;0;1;0;2;2
215;1;16;0;0;0;2;2
215;1;17;1;0;0;1;2
215;1;18;0;0;0;2;2
215;1;19;0;0;0;4;4
215;1;20;0;0;0;3;3
227;1;1;0;0;0;1;1
227;1;2;0;0;0;2;2
227;1;3;2;1;0;2;4
227;1;4;6;6;0;2;8
227;1;5;3;4;0;7;10
227;1;6;3;1;0;6;9
227;1;7;5;3;0;5;10
227;1;8;3;1;0;6;9
227;1;9;4;4;0;7;11
227;1;10;7;2;0;5;12
227;1;11;3;0;0;6;9
227;1;12;3;0;0;4;7
227;1;13;2;1;0;3;5
227;1;14;3;3;0;3;6
227;1;15;2;2;0;1;3
227;1;16;2;2;0;1;3
227;1;17;0;1;0;1;1
227;1;18;0;1;0;1;1
227;1;19;0;0;0;0;0
227;1;20;0;0;0;0;0
235;1;1;0;0;0;2;2
235;1;2;0;0;0;6;6
235;1;3;0;0;0;8;8
235;1;4;0;0;0;7;7
235;1;5;0;0;0;8;8
235;1;6;0;0;0;6;6
235;1;7;0;0;0;9;9
235;1;8;0;0;0;9;9
235;1;9;0;0;0;9;9
235;1;10;0;0;0;6;6
235;1;11;0;0;0;8;8
235;1;12;0;0;0;7;7
235;1;13;0;0;0;4;4
235;1;14;0;0;0;6;6
235;1;15;0;0;0;6;6
235;1;16;0;0;0;7;7
235;1;17;0;0;0;3;3
235;1;18;0;0;0;2;2
235;1;19;0;0;0;2;2
235;1;20;0;0;0;1;1
243;1;1;0;0;0;1;1
243;1;2;0;0;0;1;1
243;1;3;0;0;0;1;1
243;1;4;0;0;0;1;1
243;1;5;0;0;0;1;1
243;1;6;0;0;0;1;1
243;1;7;5;0;0;8;13
243;1;8;3;0;0;9;12
243;1;9;3;0;0;5;8
243;1;10;1;0;0;8;9
243;1;11;2;0;0;8;10
243;1;12;2;0;0;11;13
243;1;13;0;0;0;9;9
243;1;14;0;0;0;8;8
243;1;15;0;0;0;7;7
243;1;16;0;0;0;7;7
243;1;17;0;0;0;6;6
243;1;18;1;0;0;3;4
243;1;19;1;0;0;2;3
243;1;20;0;0;0;2;2
375;1;1;0;0;0;0;0
375;1;2;0;0;0;0;0
375;1;3;0;0;0;1;1
375;1;4;0;1;0;2;2
375;1;5;0;0;0;1;1
375;1;6;0;1;0;1;1
375;1;7;0;1;0;1;1
375;1;8;0;0;0;1;1
375;1;9;0;1;0;2;2
375;1;10;0;0;0;4;4
375;1;11;0;0;0;6;6
375;1;12;0;0;0;8;8
375;1;13;0;0;0;4;4
375;1;14;0;0;0;3;3
375;1;15;0;0;0;2;2
375;1;16;0;0;0;2;2
375;1;17;0;0;0;5;5
375;1;18;0;0;0;6;6
375;1;19;0;0;0;10;10
375;1;20;0;0;0;5;5
148;1;1;0;0;0;0;0
148;1;2;0;0;0;1;1
148;1;3;0;0;0;4;4
148;1;4;0;0;0;11;11
148;1;5;0;0;0;14;14
148;1;6;0;0;0;13;13
148;1;7;0;0;0;6;6
148;1;8;0;0;0;2;2
148;1;9;0;0;0;1;1
148;1;10;0;0;0;1;1
148;1;11;0;0;0;1;1
148;1;12;0;0;0;6;6
148;1;13;0;0;0;5;5
148;1;14;0;0;0;7;7
148;1;15;0;0;0;5;5
148;1;16;0;0;0;1;1
148;1;17;0;0;0;0;0
148;1;18;0;0;0;0;0
148;1;19;0;0;0;0;0
148;1;20;0;0;0;0;0
98;1;1;0;2;0;12;12
98;1;2;0;0;0;7;7
98;1;3;2;0;0;12;14
98;1;4;4;0;0;12;16
98;1;5;4;0;0;8;12
98;1;6;3;0;1;9;12
98;1;7;3;0;1;7;10
98;1;8;1;1;0;8;9
98;1;9;2;1;0;6;8
98;1;10;3;2;1;6;9
98;1;11;2;1;0;8;10
98;1;12;0;0;0;8;8
98;1;13;0;0;0;11;11
98;1;14;1;0;0;6;7
98;1;15;0;0;0;7;7
98;1;16;1;0;1;5;6
98;1;17;2;0;0;5;7
98;1;18;1;0;0;5;6
98;1;19;0;0;0;7;7
98;1;20;0;0;0;6;6
248;1;1;0;0;0;0;0
248;1;2;2;0;0;0;2
248;1;3;4;0;0;5;9
248;1;4;6;0;0;15;21
248;1;5;6;0;0;19;25
248;1;6;6;0;0;9;15
248;1;7;4;1;0;15;19
248;1;8;0;0;0;1;1
248;1;9;0;0;0;0;0
248;1;10;0;0;0;0;0
248;1;11;0;0;0;2;2
248;1;12;0;1;0;2;2
248;1;13;2;2;0;2;4
248;1;14;4;2;0;12;16
248;1;15;1;1;0;15;16
248;1;16;5;2;0;10;15
248;1;17;0;0;0;2;2
248;1;18;0;0;0;0;0
248;1;19;1;0;0;0;1
248;1;20;1;1;0;0;1
273;1;1;0;0;0;0;0
273;1;2;0;0;0;4;4
273;1;3;0;0;0;14;14
273;1;4;0;0;0;21;21
273;1;5;0;0;0;25;25
273;1;6;0;0;0;23;23
273;1;7;0;0;0;13;13
273;1;8;0;0;0;4;4
273;1;9;0;0;0;2;2
273;1;10;0;0;0;10;10
273;1;11;0;0;0;15;15
273;1;12;0;0;0;16;16
273;1;13;0;0;0;16;16
273;1;14;0;0;0;12;12
273;1;15;0;0;0;3;3
273;1;16;0;0;0;1;1
273;1;17;0;0;0;0;0
273;1;18;0;0;0;0;0
273;1;19;0;0;0;0;0
273;1;20;0;0;0;0;0
311;1;1;0;0;0;1;1
311;1;2;0;0;0;12;12
311;1;3;2;2;0;4;6
311;1;4;1;3;0;10;11
311;1;5;2;1;0;13;15
311;1;6;1;1;0;17;18
311;1;7;0;0;0;2;2
311;1;8;0;0;0;0;0
311;1;9;0;0;0;0;0
311;1;10;0;0;0;0;0
311;1;11;0;0;0;3;3
311;1;12;0;1;0;12;12
311;1;13;0;0;0;14;14
311;1;14;0;0;0;14;14
311;1;15;0;0;0;8;8
311;1;16;0;0;0;13;13
311;1;17;0;0;0;15;15
311;1;18;0;0;0;0;0
311;1;19;0;0;0;0;0
311;1;20;0;0;0;0;0
274;1;1;0;0;0;0;0
274;1;2;0;0;0;0;0
274;1;3;0;0;0;3;3
274;1;4;1;0;0;6;7
274;1;5;1;0;0;10;11
274;1;6;0;0;0;7;7
274;1;7;0;0;0;5;5
274;1;8;0;0;0;8;8
274;1;9;0;0;0;8;8
274;1;10;0;0;0;6;6
274;1;11;1;1;0;5;6
274;1;12;0;0;0;8;8
274;1;13;0;0;0;4;4
274;1;14;0;0;0;8;8
274;1;15;0;0;0;5;5
274;1;16;0;0;0;2;2
274;1;17;0;0;0;1;1
274;1;18;0;0;0;1;1
274;1;19;0;0;0;1;1
274;1;20;0;0;0;0;0
